16
0 16 0 4 0 0 2 12 0 3 0 0 0 0 0 0 
12 3 0 8 16 4 7 0 10 0 0 1 0 0 2 0 
0 2 1 7 5 0 3 0 6 13 9 0 8 0 10 16 
0 0 5 13 10 0 0 0 2 16 12 0 0 6 0 0 
14 9 0 11 13 7 8 0 12 10 4 0 0 0 0 2 
10 7 3 0 0 0 11 0 15 0 0 0 16 13 6 9 
16 1 0 5 6 10 12 2 0 0 3 9 0 0 0 4 
0 0 0 0 0 15 1 0 5 11 0 0 0 8 14 12 
4 8 0 0 0 0 0 0 0 15 0 0 2 5 0 6 
0 10 9 0 1 0 0 0 16 7 2 0 12 11 0 0 
13 5 14 16 0 0 0 11 0 6 0 12 0 10 3 1 
0 12 0 2 7 13 0 0 0 9 14 0 4 16 0 0 
0 13 0 0 0 0 10 4 0 2 6 0 0 0 0 0 
8 6 0 0 15 1 5 0 0 4 10 0 14 2 0 0 
0 0 0 9 0 0 13 8 14 0 0 0 6 0 0 0 
0 15 0 0 0 0 0 6 8 12 5 0 1 4 0 0 
