16
10 0 3 0 6 8 0 0 12 0 2 0 0 1 11 16 
8 9 0 15 0 0 0 0 4 6 0 11 0 14 0 5 
5 0 16 2 14 0 12 0 0 0 0 10 0 0 9 0 
0 0 0 1 3 0 0 0 5 0 13 0 0 0 0 8 
0 11 0 0 15 0 7 14 0 0 5 3 10 16 2 0 
1 7 4 0 0 5 8 2 13 12 0 16 0 0 0 9 
0 10 8 0 0 0 0 0 2 11 7 4 5 3 0 15 
0 0 2 5 0 0 0 13 6 0 10 14 7 8 1 12 
0 2 0 16 12 0 0 0 0 5 3 0 0 15 0 14 
12 0 10 7 16 0 0 0 0 0 0 1 0 0 8 0 
0 0 5 4 0 11 3 9 0 16 6 0 0 2 7 0 
0 13 1 0 5 7 0 0 0 15 0 0 4 9 16 6 
0 0 0 0 2 0 0 12 0 3 9 0 0 0 0 0 
16 0 13 9 0 0 0 3 7 10 0 0 0 0 0 0 
2 3 0 10 9 0 0 5 0 4 0 8 16 0 14 13 
0 5 12 11 7 0 0 8 0 0 1 0 9 0 0 10 
