16
8 14 0 6 0 0 9 4 0 13 3 0 1 7 0 0 
16 0 0 13 1 0 0 0 8 4 0 0 9 0 2 3 
0 0 15 2 11 16 0 12 0 7 9 0 8 13 0 0 
12 0 0 0 0 0 0 13 10 0 2 14 0 0 0 6 
10 2 13 0 7 0 0 0 5 0 11 15 0 0 0 0 
0 1 3 0 0 0 0 0 0 12 14 0 0 2 7 13 
0 9 0 8 12 0 14 0 0 0 0 2 16 0 4 11 
14 0 6 7 5 2 0 11 0 0 16 0 3 0 0 9 
1 11 0 15 0 0 0 0 3 2 0 9 0 0 0 0 
0 10 7 12 0 0 15 0 14 16 0 5 2 3 6 1 
13 6 8 5 0 3 0 7 0 1 0 0 0 0 15 16 
2 0 0 0 10 12 0 0 15 11 0 7 0 8 9 4 
6 0 0 4 8 7 0 10 0 14 0 0 0 0 0 0 
0 0 16 14 0 0 12 0 0 8 0 6 10 4 13 0 
0 8 12 0 0 4 0 0 7 0 0 16 0 11 3 2 
11 0 2 10 0 5 16 0 0 0 0 3 0 0 0 0 
