16
16 0 2 0 4 0 0 0 0 0 0 5 1 0 0 9 
0 11 0 0 0 0 14 0 9 0 16 12 0 4 0 0 
0 9 5 14 1 0 7 15 2 0 4 0 11 0 0 0 
0 0 0 7 10 9 0 5 0 0 1 0 0 0 13 15 
10 0 6 13 16 2 15 0 0 11 8 9 0 5 3 0 
0 8 14 0 0 0 11 0 7 2 12 4 0 13 0 0 
0 0 0 0 9 0 5 0 15 3 0 0 0 0 2 14 
2 15 0 0 12 0 13 1 14 10 0 0 0 0 0 7 
14 5 9 6 0 0 2 0 8 0 0 7 13 1 11 4 
0 0 15 8 7 12 0 0 0 0 9 1 14 0 6 2 
0 16 12 4 0 1 8 0 0 0 0 2 10 3 0 0 
0 1 13 2 5 0 0 4 0 0 10 0 0 0 12 0 
1 2 0 10 0 16 4 0 3 0 6 0 0 0 5 13 
13 6 0 3 0 0 0 7 16 0 0 10 0 0 0 11 
0 4 0 0 0 13 0 0 12 7 0 0 15 0 1 0 
15 14 7 12 0 5 0 9 0 1 0 0 3 0 0 0 
