16
0 0 6 7 0 0 9 0 15 0 12 1 0 0 0 0 
10 0 0 15 0 8 0 0 11 0 0 4 2 0 0 0 
4 0 0 3 0 15 0 0 5 0 0 0 7 1 0 0 
9 8 0 0 11 0 0 1 0 0 0 0 0 5 0 0 
2 10 0 11 0 4 3 12 0 0 0 14 16 0 0 6 
12 0 0 0 0 2 0 0 4 0 6 8 13 0 14 0 
14 0 0 0 10 11 15 0 0 0 0 0 3 4 2 0 
7 0 0 0 5 0 16 0 3 0 11 9 0 0 1 0 
6 7 2 0 13 5 8 0 0 1 9 15 0 0 4 0 
13 5 0 9 0 0 12 4 0 11 10 3 6 16 0 0 
0 0 11 0 3 9 14 2 6 5 4 12 1 0 7 8 
0 14 0 1 6 16 10 15 8 0 0 0 0 11 5 0 
0 3 10 0 7 0 0 0 0 8 0 5 12 0 0 0 
0 12 0 16 15 1 5 9 0 0 0 11 4 0 6 3 
15 0 13 14 0 0 0 0 12 0 0 0 0 9 0 7 
0 0 0 0 16 12 2 3 7 0 15 10 14 8 13 0 
