16
1 10 14 0 9 3 12 0 13 0 0 0 0 5 16 0 
6 0 9 0 1 0 5 0 0 0 8 14 7 4 0 10 
0 7 4 0 14 10 13 0 0 16 2 1 0 0 0 0 
0 12 0 0 0 0 0 0 0 10 0 15 0 0 0 0 
10 13 12 4 0 0 8 0 0 14 3 0 5 0 0 9 
9 0 0 0 0 0 14 1 0 12 0 0 0 7 0 0 
0 1 0 0 15 0 9 0 6 8 10 4 0 0 3 16 
16 0 0 7 0 0 0 0 1 0 0 9 10 0 0 6 
4 2 0 1 0 14 0 0 3 0 13 0 15 0 0 0 
0 0 0 5 6 0 0 13 0 0 14 12 16 9 7 0 
12 14 0 10 0 9 0 15 0 0 16 0 4 3 11 0 
13 0 0 0 8 0 4 3 0 0 1 0 0 0 10 14 
8 15 0 14 0 4 0 0 10 2 7 0 6 16 5 0 
0 5 0 6 16 12 2 14 9 0 4 0 8 0 13 0 
11 0 13 0 0 1 15 10 0 0 12 6 3 14 4 2 
0 0 3 12 13 8 0 0 0 0 0 0 0 10 9 0 
