16
11 0 0 0 0 9 0 5 0 0 0 12 7 0 15 0 
0 0 0 0 8 0 0 3 6 0 7 15 14 0 10 9 
0 0 0 0 14 10 15 0 3 5 0 4 0 0 0 0 
14 0 7 15 0 0 0 2 0 10 16 1 3 0 0 0 
13 0 14 1 0 0 0 11 0 0 0 16 10 0 6 0 
2 0 0 5 0 0 1 0 12 0 0 0 0 0 3 0 
0 3 4 12 0 0 7 10 0 15 6 0 0 0 2 0 
10 0 9 0 0 0 0 8 0 3 0 0 0 14 12 0 
0 0 13 16 10 2 0 12 0 1 0 0 0 7 0 15 
7 0 10 9 16 4 14 0 0 8 0 11 0 3 0 0 
5 0 15 2 1 8 11 0 16 0 3 10 0 13 9 14 
4 11 0 3 7 5 0 0 14 0 12 13 0 0 1 0 
9 13 2 0 0 0 0 1 15 16 0 0 0 0 4 3 
15 5 0 7 3 0 0 0 4 0 0 0 0 0 0 0 
16 4 12 6 0 0 8 14 10 9 1 0 0 11 7 0 
3 10 0 0 0 12 0 0 7 13 2 6 1 0 16 8 
