16
0 15 10 0 0 0 12 3 0 0 7 0 0 8 5 0 
16 0 13 0 0 2 15 0 12 0 10 0 0 3 9 6 
0 0 1 0 11 0 5 13 0 0 8 16 2 14 0 0 
0 0 0 8 0 7 0 9 3 0 0 6 0 0 1 13 
0 0 0 10 0 0 7 0 15 14 0 1 0 0 2 0 
14 4 11 0 5 8 2 0 0 0 0 12 0 7 0 0 
0 9 2 0 0 14 10 0 8 13 5 0 0 6 0 4 
0 16 12 0 0 0 0 15 0 10 4 2 0 11 0 9 
4 0 8 9 7 13 11 0 0 0 12 0 0 16 6 0 
10 2 0 0 0 5 14 12 11 7 6 13 9 1 4 3 
3 0 0 12 6 0 0 10 0 9 0 14 13 0 8 0 
0 0 14 5 0 15 0 0 0 0 0 0 10 0 7 11 
13 5 0 16 9 0 0 14 0 4 0 0 6 10 0 7 
12 0 0 0 0 10 0 0 5 6 0 0 0 0 0 1 
0 8 0 2 15 12 0 16 0 11 9 0 5 4 0 14 
0 0 0 0 0 0 0 0 0 12 0 15 0 9 16 0 
