16
3 1 0 2 0 14 0 15 16 0 12 0 8 11 0 5 
11 0 0 0 8 0 0 0 0 4 0 0 16 3 0 0 
0 0 15 0 13 0 0 0 1 3 0 11 10 4 12 14 
0 0 0 0 5 0 0 3 0 0 0 8 0 0 0 0 
2 3 7 6 11 0 12 10 0 14 4 0 13 8 0 0 
0 16 0 11 0 7 0 14 0 0 8 0 0 2 4 12 
15 12 8 9 0 4 1 13 0 0 0 0 14 0 0 0 
13 0 0 4 0 8 5 0 12 0 11 15 0 7 3 0 
10 7 0 0 15 3 0 8 0 0 0 0 0 0 11 6 
0 0 16 0 14 0 0 0 4 0 0 0 2 0 15 3 
5 0 4 12 0 11 13 9 6 8 0 3 7 0 0 0 
6 11 3 0 12 1 16 0 0 0 0 13 0 0 8 10 
0 0 1 5 0 16 0 0 0 15 6 7 0 0 10 0 
16 8 0 0 0 6 14 0 13 0 1 4 3 0 9 0 
14 2 0 0 0 13 0 0 8 10 9 0 11 0 1 0 
4 0 6 15 0 0 0 11 0 12 0 14 0 0 0 7 
