16
8 9 10 6 3 16 5 2 0 4 14 13 0 15 0 0 
0 0 0 15 1 0 0 6 0 12 2 0 0 0 0 0 
0 3 0 1 9 11 7 0 10 0 0 0 0 2 0 8 
7 0 2 0 10 12 15 14 3 16 9 0 0 1 0 13 
6 0 0 12 0 0 2 0 15 0 0 0 0 7 0 0 
0 4 14 0 5 7 3 16 9 6 0 10 11 0 1 0 
0 0 1 16 14 15 0 0 13 8 0 0 10 0 12 0 
9 15 0 0 6 1 0 0 14 7 3 0 13 0 0 0 
15 2 6 11 8 0 0 0 7 3 13 0 4 12 9 0 
0 0 13 0 0 6 0 4 0 0 0 12 0 11 0 0 
0 12 0 7 0 0 11 5 0 10 4 0 15 0 0 0 
0 16 4 0 0 3 0 0 6 0 8 11 0 0 0 5 
11 0 9 0 0 0 0 3 4 0 0 0 0 16 0 7 
0 0 7 0 4 5 0 1 0 0 11 0 14 0 15 10 
4 0 0 0 16 0 0 0 5 14 0 0 12 9 0 0 
13 0 16 0 0 8 10 0 12 0 7 0 0 0 5 1 
