16
7 0 8 12 0 2 14 0 0 0 0 0 0 0 0 1 
15 5 2 0 0 0 0 0 14 0 10 6 9 0 11 0 
0 0 0 4 12 11 5 0 0 15 3 0 16 0 0 8 
1 0 0 0 0 0 0 9 2 0 5 12 0 0 7 0 
0 4 5 0 9 12 0 0 0 11 0 3 0 0 15 0 
0 0 0 8 0 0 2 0 0 0 0 10 13 3 0 11 
11 0 0 0 0 3 6 0 4 9 8 0 2 12 5 0 
3 0 12 0 11 13 0 0 0 2 6 0 0 0 0 0 
14 2 0 0 0 16 15 0 10 0 13 9 0 7 0 6 
8 12 9 6 14 0 11 1 0 0 0 0 0 0 16 4 
13 0 0 7 3 9 0 0 0 0 16 0 11 0 0 2 
5 16 3 15 13 7 4 0 6 12 0 0 8 1 0 9 
6 0 0 0 8 0 9 16 0 0 0 2 4 11 0 0 
4 0 14 2 0 0 0 0 16 6 12 8 7 0 0 3 
12 8 0 9 0 0 7 0 3 0 0 0 14 0 0 5 
10 0 7 0 4 6 3 0 9 0 0 11 0 2 8 13 
