16
0 0 0 2 7 1 8 15 0 9 3 0 0 4 12 0 
0 0 0 0 0 16 0 5 0 0 14 0 0 3 0 9 
16 0 0 0 3 11 0 0 0 12 0 8 0 0 0 13 
0 0 8 3 0 2 6 0 0 0 4 11 0 0 0 0 
0 0 13 6 0 7 14 1 16 0 0 0 5 12 0 0 
0 0 0 0 11 12 15 0 7 0 10 9 0 13 1 0 
0 0 0 10 0 3 0 0 14 1 0 0 0 0 15 0 
12 3 1 0 6 0 10 0 11 0 8 4 9 0 7 14 
5 0 2 12 4 6 0 3 0 14 11 0 0 9 8 0 
0 16 14 0 0 0 0 0 13 4 0 0 7 0 5 3 
7 0 0 11 8 14 0 9 3 16 5 1 0 0 0 12 
3 10 0 0 1 5 0 11 0 8 2 15 13 0 6 0 
0 0 0 13 15 4 11 16 0 0 0 5 12 0 14 8 
0 0 5 9 0 10 0 7 0 11 0 14 16 6 3 0 
0 15 10 14 0 9 0 6 8 2 0 0 0 0 0 0 
2 0 12 0 0 8 0 0 0 15 0 3 10 0 0 0 
