16
16 0 7 3 12 0 0 0 0 9 0 0 0 13 0 0 
0 9 8 0 0 0 0 7 0 16 0 6 0 5 0 10 
0 0 0 0 0 0 6 0 15 7 11 5 0 0 16 0 
10 6 14 0 0 1 2 15 0 8 13 4 0 0 0 12 
7 14 2 1 0 15 0 8 4 6 10 12 3 9 13 0 
3 0 0 0 0 0 1 0 0 2 0 16 0 0 12 7 
9 0 0 0 0 4 0 0 0 0 0 3 0 0 0 0 
5 0 0 0 0 10 0 0 7 0 8 13 14 0 4 6 
2 1 4 0 0 0 12 0 8 15 3 11 0 0 14 0 
13 0 15 0 0 2 0 14 0 12 1 9 5 8 0 0 
14 3 11 0 13 0 15 16 0 0 5 0 12 6 10 1 
8 5 12 0 7 0 0 0 13 10 0 0 0 2 15 9 
0 0 1 0 8 14 0 6 0 0 0 2 0 0 0 11 
11 0 0 2 1 16 10 3 0 5 6 15 0 0 0 8 
0 0 0 0 2 0 5 4 0 0 0 0 6 10 0 15 
0 10 5 0 15 0 0 11 0 14 0 0 9 0 3 0 
