16
14 0 0 7 2 0 0 0 11 0 6 0 5 0 0 0 
9 2 0 10 0 0 7 14 0 3 4 0 8 0 1 11 
0 0 5 6 10 0 0 0 16 9 0 0 2 4 12 3 
0 11 1 0 12 4 0 13 0 10 8 0 6 7 14 9 
12 0 0 5 0 15 0 0 0 0 2 0 0 9 4 7 
3 4 2 8 7 1 13 5 0 0 12 16 14 10 0 0 
0 0 15 14 0 2 9 0 1 0 13 5 0 0 0 6 
16 0 6 0 11 0 0 0 0 4 10 0 0 0 0 8 
0 8 14 0 0 0 0 0 0 2 0 0 16 0 0 0 
4 0 0 13 0 10 0 0 0 7 16 6 0 11 9 0 
0 0 0 2 0 8 0 16 13 0 5 12 0 0 0 4 
0 1 7 0 0 13 4 2 3 14 0 0 0 0 0 5 
13 14 0 12 0 0 0 0 0 5 0 8 0 6 15 0 
1 5 0 0 0 0 15 0 0 13 0 0 9 16 2 12 
0 6 10 4 0 0 0 0 15 0 9 0 3 8 13 0 
0 16 8 0 13 0 10 0 6 0 3 0 0 0 0 1 
