16
0 0 0 0 7 0 12 6 5 15 0 0 0 0 4 10 
0 12 10 5 15 1 8 0 0 7 0 0 11 6 13 16 
0 0 0 1 0 14 0 0 12 0 0 0 0 0 0 0 
0 0 6 0 0 0 4 10 0 0 3 0 0 2 0 0 
12 0 3 0 9 0 14 0 0 0 8 6 15 0 11 0 
0 6 0 4 1 0 0 0 3 0 15 5 10 12 0 0 
0 11 8 7 12 0 10 5 0 2 1 14 6 0 0 9 
10 0 9 14 0 3 15 0 11 12 7 4 1 0 16 0 
4 8 16 3 10 0 0 15 0 0 5 1 0 0 0 0 
0 7 12 15 0 16 0 0 10 0 11 13 5 0 9 6 
9 0 5 0 0 0 7 0 0 6 16 2 0 15 14 0 
0 13 0 2 0 5 0 9 0 0 12 15 0 0 8 11 
0 0 0 12 0 7 5 0 2 8 10 3 13 9 6 15 
11 9 0 0 0 10 0 0 15 0 0 12 4 0 0 3 
0 0 0 0 14 12 0 1 4 0 0 0 0 0 0 0 
0 2 0 10 0 0 9 0 0 0 13 11 0 0 0 5 
