16
15 0 10 0 0 4 0 0 0 12 0 9 3 0 0 11 
13 12 0 0 0 0 14 9 0 0 7 0 1 4 0 0 
0 0 0 7 15 0 0 11 0 2 0 4 0 12 0 8 
3 9 0 4 0 8 5 12 15 13 1 0 7 10 14 2 
8 0 0 0 4 0 0 0 0 0 3 1 15 6 0 0 
0 0 0 3 7 9 0 1 0 15 11 0 12 0 8 16 
0 6 0 11 0 3 0 14 0 0 4 8 2 1 7 0 
1 0 0 0 8 6 0 15 13 0 0 14 0 0 0 0 
0 5 2 0 0 14 0 0 7 0 0 0 4 0 1 15 
11 13 0 14 16 5 0 0 1 3 15 0 6 7 9 0 
16 3 6 0 11 1 7 0 0 14 0 5 0 13 2 0 
7 0 0 1 0 15 2 0 11 0 0 0 14 16 0 0 
0 0 0 0 12 2 0 0 9 0 0 0 0 0 0 0 
2 0 14 9 1 13 0 0 0 0 0 10 16 0 0 7 
0 15 0 0 0 0 0 0 14 8 2 7 0 9 0 1 
5 8 13 12 14 7 0 0 6 1 0 0 0 0 10 0 
