16
6 10 0 0 0 0 7 16 0 14 3 0 0 0 0 5 
0 0 0 0 2 5 0 6 0 0 0 0 0 8 13 0 
12 4 9 0 15 3 14 8 2 5 10 0 0 16 11 0 
0 8 0 0 0 9 4 1 0 0 0 16 0 2 0 14 
11 12 0 14 0 1 0 4 9 0 8 2 0 5 10 3 
0 0 0 0 0 0 2 0 0 3 16 0 1 11 7 0 
10 0 15 3 0 0 0 11 4 0 0 0 0 13 0 2 
13 1 16 2 0 15 0 0 11 0 0 0 0 0 0 9 
0 0 8 15 0 0 0 0 10 0 0 6 2 7 0 0 
1 9 0 0 4 0 15 10 8 16 12 0 0 14 3 13 
4 16 0 13 0 6 1 0 0 0 0 0 10 15 0 0 
14 2 0 0 13 8 12 0 0 9 15 7 11 6 0 0 
15 13 11 9 1 0 0 0 16 10 4 14 0 3 0 0 
2 0 0 0 0 11 3 0 6 0 0 12 13 0 5 0 
0 7 0 12 0 0 6 0 3 13 0 9 15 0 2 0 
8 0 1 0 9 0 0 0 0 0 0 0 0 12 0 11 
