16
0 6 1 9 16 0 5 0 0 4 0 14 0 11 0 8 
0 0 0 12 4 0 0 0 0 1 0 11 13 0 0 9 
16 0 0 0 8 11 9 1 3 0 13 2 7 15 0 0 
0 0 0 3 0 0 0 6 9 12 16 8 0 5 0 0 
8 0 0 11 0 0 10 12 0 0 4 0 0 0 13 0 
0 2 13 0 0 0 11 14 0 10 15 0 0 0 4 0 
12 15 14 4 0 2 8 0 11 3 5 0 0 0 10 0 
0 7 9 10 0 0 0 3 0 16 12 13 0 0 8 0 
1 0 0 0 2 0 16 0 4 8 11 0 10 0 0 0 
0 0 10 0 0 4 0 11 0 0 0 0 8 16 14 0 
0 0 0 8 0 6 0 0 2 13 14 16 0 0 0 0 
4 0 0 0 0 5 0 8 1 9 10 6 0 7 2 0 
9 1 0 0 0 0 12 5 7 11 2 0 14 8 0 0 
0 3 12 2 1 0 13 0 16 0 0 0 6 10 0 0 
10 16 8 0 14 7 0 0 0 15 0 0 0 13 0 0 
14 0 7 0 11 8 0 0 13 6 1 10 9 3 12 0 
