16
3 14 10 7 0 13 4 0 1 12 0 9 0 0 0 0 
0 0 8 9 10 2 0 7 0 16 6 5 0 0 0 3 
0 4 0 2 6 3 0 0 0 10 0 0 0 14 0 0 
0 6 0 0 14 0 5 8 11 13 0 0 0 2 0 10 
0 3 0 0 0 0 2 0 12 6 9 0 10 13 4 1 
4 9 0 0 0 0 0 0 0 0 0 2 15 0 0 0 
10 2 0 1 0 0 0 6 15 0 13 0 0 3 8 0 
0 12 0 13 0 14 11 0 0 0 0 1 0 0 2 16 
12 0 9 3 0 8 1 14 0 2 11 10 16 7 6 0 
0 0 13 10 0 0 3 0 0 0 12 0 1 0 11 4 
0 8 0 15 11 10 0 0 0 1 0 3 0 12 0 0 
0 0 2 0 0 0 16 4 13 0 7 6 5 0 3 0 
1 15 0 0 3 9 10 0 8 4 0 0 2 6 0 11 
0 10 0 0 0 0 0 0 0 0 1 7 4 15 13 0 
0 0 0 4 5 0 0 1 2 0 0 0 9 16 12 0 
9 0 0 0 4 7 0 0 16 0 5 13 3 0 10 14 
