16
11 14 0 0 0 4 0 0 0 1 0 16 0 15 0 5 
16 10 12 0 0 8 14 1 0 0 15 0 0 2 0 0 
8 5 0 0 0 0 0 3 7 0 12 0 0 0 0 0 
4 0 3 9 0 11 6 0 8 0 0 0 1 10 0 7 
0 16 11 0 14 5 0 6 2 10 0 0 7 1 0 8 
13 9 0 0 0 0 7 2 1 0 14 0 6 3 0 0 
3 0 0 10 4 0 9 0 0 0 16 0 5 0 0 0 
0 0 0 0 0 0 12 0 4 3 7 0 0 0 0 0 
0 12 0 2 0 13 0 14 11 15 0 7 0 4 10 1 
1 0 0 11 9 3 0 5 13 0 0 12 0 7 0 0 
0 0 7 0 1 12 0 10 0 2 8 4 0 13 0 0 
5 13 0 15 0 7 11 4 0 14 1 9 0 0 0 2 
7 0 14 0 11 0 4 0 15 9 0 1 0 5 16 10 
0 2 0 0 0 9 0 7 0 0 11 10 4 0 1 0 
0 4 9 0 2 0 1 8 0 16 0 0 0 11 7 0 
0 11 0 0 3 0 16 15 5 0 4 0 9 0 6 0 
