16
0 0 0 15 0 0 0 0 9 2 10 13 0 0 0 0 
10 14 0 1 13 0 0 9 0 12 5 4 0 0 0 16 
9 13 0 7 0 0 0 0 3 1 0 0 0 14 8 0 
0 0 0 16 3 1 0 0 0 0 0 6 0 11 0 0 
6 9 14 13 12 10 0 8 0 11 2 0 0 15 0 3 
11 0 0 12 16 9 0 0 0 6 13 0 2 1 7 10 
1 0 10 0 0 13 0 0 0 0 8 15 14 12 11 0 
0 0 7 0 15 0 2 0 14 0 1 12 0 0 6 0 
0 0 2 6 0 11 12 0 0 0 0 0 1 9 0 0 
0 10 5 8 1 16 6 0 0 0 0 0 11 0 0 2 
0 0 15 0 0 8 9 13 11 0 6 0 16 4 0 12 
16 0 0 0 2 3 4 10 1 0 12 0 8 7 14 0 
13 0 3 11 9 14 10 16 15 0 0 0 5 6 2 0 
0 0 16 0 0 0 0 0 12 0 0 0 0 0 9 4 
0 0 1 0 4 5 0 0 0 16 9 10 13 0 0 0 
0 6 0 10 0 15 0 12 2 5 0 14 3 16 0 0 
