16
14 0 0 11 3 0 1 4 8 0 0 0 0 0 12 0 
0 1 0 16 0 0 14 0 15 7 12 0 0 9 4 6 
0 0 15 0 0 16 2 0 1 11 0 0 8 14 3 13 
4 0 10 0 0 9 0 6 0 0 0 0 0 15 7 0 
6 5 0 0 0 0 0 3 9 0 15 0 4 8 10 0 
15 13 8 0 0 0 0 0 7 0 0 0 6 0 16 12 
0 3 0 14 0 8 4 16 6 0 10 0 0 0 15 0 
7 10 0 0 0 6 0 0 0 0 0 0 0 0 1 0 
0 0 0 0 0 0 8 0 0 3 9 15 10 0 0 0 
0 7 3 8 0 0 11 0 0 6 0 13 0 1 0 4 
0 11 0 0 4 2 3 0 16 1 7 0 14 6 0 15 
0 0 0 15 6 1 5 7 12 0 11 4 0 2 0 0 
0 4 0 0 13 0 0 8 11 15 0 0 16 0 14 0 
0 14 6 7 15 10 0 0 4 9 1 3 13 0 0 8 
12 15 13 1 11 0 9 0 10 0 0 14 7 0 6 3 
8 16 0 3 0 0 0 14 13 12 0 0 0 10 0 0 
