16
13 0 14 0 0 8 0 0 0 12 10 0 0 3 2 5 
6 0 16 8 0 10 12 3 0 5 0 9 11 15 0 0 
11 2 0 0 0 0 6 15 0 14 8 0 16 0 1 0 
0 3 0 15 13 1 2 14 0 6 0 16 0 0 8 4 
8 5 6 11 14 13 0 0 1 10 12 0 0 0 9 16 
1 14 0 0 0 0 10 4 3 16 9 8 12 5 0 7 
0 0 0 0 0 16 0 0 6 0 5 11 14 0 13 0 
0 0 0 0 0 0 0 8 13 7 0 0 0 1 6 0 
10 6 8 12 5 14 0 0 0 15 7 0 0 2 0 0 
2 0 11 0 0 0 9 0 0 3 0 0 0 13 0 0 
14 0 5 9 15 3 8 0 12 0 0 0 0 6 0 11 
0 0 13 0 2 7 4 0 8 0 6 5 10 14 12 0 
12 0 0 5 0 0 0 9 0 0 0 0 0 16 0 0 
0 13 1 0 0 15 0 0 11 2 0 12 0 0 0 0 
0 0 0 10 8 4 0 6 0 0 1 0 13 11 0 0 
9 11 0 0 10 12 0 2 0 0 15 0 4 0 0 0 
