16
0 0 0 0 2 0 0 9 0 0 0 16 8 15 3 13 
0 0 0 2 0 0 0 11 0 10 0 13 7 14 0 0 
0 0 9 12 15 1 10 0 3 11 0 0 0 16 4 5 
1 7 0 5 0 0 8 0 0 15 0 0 11 0 12 0 
5 0 0 7 14 8 0 12 0 9 0 0 0 13 10 3 
0 0 13 0 10 7 0 0 0 5 0 3 4 0 16 11 
3 4 12 1 9 0 0 0 0 13 0 0 0 8 0 0 
16 15 0 0 0 0 4 0 8 14 0 0 0 9 0 2 
0 0 16 13 0 4 12 2 15 3 8 14 0 7 0 9 
12 9 14 0 0 0 0 0 5 0 0 6 0 0 0 0 
0 0 15 0 0 10 16 0 13 0 0 0 0 0 0 12 
7 0 2 3 0 9 0 8 0 4 0 12 0 11 0 0 
11 0 5 15 1 0 13 7 0 0 0 10 0 0 0 8 
9 0 4 14 0 0 11 0 7 2 3 0 0 6 1 16 
0 10 7 8 0 2 14 3 11 0 13 1 9 0 15 4 
0 13 1 0 0 0 0 0 14 0 12 0 0 0 11 7 
