16
0 9 0 0 11 16 1 13 2 0 0 0 0 10 5 0 
2 0 0 0 8 7 0 0 16 11 5 4 0 0 0 6 
4 0 5 0 0 10 0 2 0 0 6 15 16 0 0 0 
12 8 0 0 5 14 0 4 0 3 0 0 13 2 1 11 
16 4 0 10 0 0 0 11 0 0 0 3 12 1 0 13 
5 0 0 0 0 0 7 3 11 6 0 1 0 0 0 2 
0 13 0 15 0 0 0 10 0 2 0 0 0 11 0 0 
0 2 0 7 12 4 13 1 8 16 0 0 5 15 0 14 
0 0 0 0 14 11 0 0 13 7 0 0 0 0 0 0 
10 5 4 0 0 12 9 0 3 15 11 16 0 0 2 0 
0 0 16 2 13 1 10 0 0 0 4 0 9 0 0 3 
0 15 0 11 2 0 0 0 12 0 0 0 0 7 4 0 
0 14 11 5 1 0 12 0 10 0 16 0 0 0 15 0 
8 1 2 6 0 0 5 14 7 0 3 13 11 9 10 0 
3 7 0 0 10 2 0 0 5 0 15 0 8 0 0 1 
15 16 0 4 0 0 8 0 0 1 0 0 0 0 0 12 
