16
3 0 0 0 0 6 0 0 0 10 0 0 0 5 0 8 
10 6 0 4 15 0 3 0 0 1 11 0 0 0 0 0 
0 16 0 0 11 0 0 9 0 4 5 2 0 0 1 6 
0 0 0 11 4 0 13 0 0 15 0 16 0 3 0 0 
0 4 0 16 13 8 1 0 2 14 0 0 15 0 6 0 
2 0 0 13 14 0 0 0 0 8 0 10 0 16 0 11 
6 0 12 10 0 0 15 11 1 5 0 0 8 4 0 0 
0 8 0 5 12 0 9 0 11 6 0 0 0 2 0 14 
0 0 4 0 7 13 8 15 0 0 0 0 6 0 0 1 
1 0 6 0 0 0 0 0 0 12 0 3 0 14 0 13 
7 0 0 0 3 0 10 12 4 13 1 6 16 8 0 0 
16 2 13 8 5 0 0 0 7 9 10 15 3 0 11 4 
4 3 0 0 1 0 5 13 0 16 2 14 12 11 0 0 
0 0 0 2 0 0 0 0 9 3 0 0 0 10 8 5 
5 13 11 0 0 0 2 0 0 7 0 4 9 6 14 3 
0 0 0 0 10 15 0 3 0 11 0 5 0 1 0 0 
