16
0 15 6 16 7 0 11 13 2 12 0 3 0 4 0 0 
2 13 0 1 16 0 14 9 8 0 0 0 11 6 0 5 
5 3 0 0 1 0 0 12 0 0 0 0 0 2 14 0 
0 8 0 9 0 3 0 0 5 0 0 0 0 16 12 0 
0 0 0 2 6 4 12 7 11 0 0 0 1 10 8 0 
0 1 0 6 3 16 0 15 12 0 0 0 0 0 0 0 
10 12 0 13 0 0 0 0 16 9 4 1 6 0 0 0 
0 0 14 0 0 0 0 0 0 6 7 2 0 0 0 16 
16 0 10 12 0 1 0 11 14 0 8 9 0 5 0 6 
3 9 13 0 0 0 8 14 6 4 2 5 0 0 0 12 
4 2 0 5 9 12 0 0 7 11 16 0 0 14 0 0 
0 14 8 15 4 0 0 5 1 10 0 0 3 9 7 0 
0 0 0 0 14 0 7 16 9 0 0 0 15 0 0 0 
0 6 2 0 8 0 15 4 10 0 0 16 5 7 0 0 
0 0 16 0 5 0 10 3 0 0 15 0 0 0 0 2 
0 10 0 0 12 6 0 2 3 14 0 0 0 0 0 4 
