16
10 3 1 0 0 11 0 0 16 7 13 14 0 0 0 0 
0 9 0 0 0 13 0 0 3 4 5 2 14 7 8 10 
0 0 7 2 0 3 0 0 0 11 6 0 0 0 16 4 
14 0 0 0 0 5 7 9 0 8 0 12 11 0 0 15 
0 12 0 9 11 0 0 0 5 0 1 7 0 2 0 8 
0 1 8 0 4 0 0 2 0 0 0 0 0 6 14 0 
0 6 0 0 0 0 12 0 13 0 14 3 10 0 0 0 
2 14 0 3 9 0 0 0 0 10 8 11 12 0 7 0 
13 0 5 0 7 0 8 11 0 0 0 0 0 0 3 0 
0 0 14 8 10 9 15 0 0 3 0 4 0 16 0 2 
0 2 9 12 0 0 0 0 10 14 0 0 0 11 1 6 
4 0 3 1 0 2 16 0 0 0 0 0 0 10 9 7 
3 8 6 0 0 0 0 0 0 0 0 13 0 14 11 1 
0 13 0 0 6 0 0 0 9 5 11 0 0 15 2 12 
11 0 12 0 13 0 0 0 14 0 0 1 6 8 0 3 
0 0 2 0 1 16 0 0 8 0 3 6 7 4 5 13 
