16
10 0 0 12 14 0 0 0 11 0 4 7 16 0 0 0 
0 0 11 15 2 0 16 0 6 1 0 13 0 0 0 12 
2 0 0 16 0 7 4 0 0 5 0 12 1 11 10 6 
0 0 1 3 12 0 0 0 10 16 2 15 7 0 0 4 
6 0 0 0 0 16 0 0 0 7 0 0 0 9 0 3 
16 12 8 0 7 11 0 3 0 0 13 0 14 0 0 0 
15 0 0 0 1 0 0 8 5 6 11 0 0 0 0 0 
3 7 9 13 10 0 6 2 0 14 0 16 5 8 0 1 
0 0 0 0 0 9 5 0 14 2 16 8 11 0 12 0 
0 0 0 4 11 0 0 0 0 3 1 0 0 0 5 8 
14 0 0 0 0 0 12 10 13 0 7 5 3 4 0 0 
0 5 0 11 0 8 3 7 4 12 0 0 15 14 1 2 
12 1 0 0 0 6 10 4 0 0 3 11 0 15 0 0 
0 0 0 6 0 15 0 0 0 0 0 0 0 0 3 0 
0 0 16 0 0 0 2 0 0 0 9 6 4 13 7 14 
0 13 0 9 8 0 7 0 2 15 0 0 10 0 6 11 
