16
11 15 5 2 0 0 9 6 0 13 8 0 0 10 14 0 
0 0 6 3 0 8 12 0 0 4 0 0 0 5 7 2 
1 7 4 0 0 3 5 0 15 14 0 16 0 0 0 11 
13 0 0 8 14 0 0 1 0 5 0 2 3 0 0 6 
10 11 0 0 8 5 1 0 14 2 0 13 0 0 0 7 
0 0 1 0 12 15 0 0 0 0 0 5 0 0 0 0 
0 12 13 6 0 9 2 0 3 11 4 0 0 0 1 5 
0 0 16 0 6 0 13 0 0 1 0 0 0 0 2 3 
0 0 11 0 0 0 15 0 4 0 0 7 0 1 0 10 
0 6 10 7 5 0 0 0 0 12 0 0 0 9 0 0 
12 0 14 0 9 0 7 0 0 0 3 11 2 0 0 16 
4 3 0 0 1 0 11 0 2 0 5 0 0 0 13 12 
0 10 7 12 0 0 6 0 1 8 2 14 11 0 16 0 
0 4 0 0 0 10 0 0 0 15 0 0 5 0 12 14 
0 13 2 5 0 12 14 0 10 0 0 4 0 7 0 0 
0 14 0 11 15 1 16 2 5 3 0 0 0 6 4 0 
