16
0 0 10 0 0 7 0 2 0 0 0 11 0 9 0 0 
15 0 0 6 0 0 10 16 0 0 0 0 0 2 0 0 
8 0 1 0 5 3 13 4 16 0 14 0 6 15 12 0 
0 0 0 2 0 0 8 14 0 0 6 0 4 0 0 0 
0 16 9 14 0 0 0 10 1 0 0 0 13 0 3 7 
12 3 6 0 7 1 16 0 14 0 0 8 2 0 0 0 
10 5 0 0 9 0 3 0 13 0 0 15 12 11 16 0 
0 8 0 0 4 0 0 0 0 3 0 0 0 6 0 0 
6 4 15 0 0 16 0 0 10 0 0 0 9 7 14 0 
0 10 0 0 0 12 9 0 4 15 11 0 8 0 2 0 
0 1 11 16 0 4 0 0 12 0 0 6 15 13 0 0 
13 0 5 12 10 0 0 0 7 0 1 0 0 0 6 0 
0 0 12 7 11 0 4 9 6 0 5 1 3 16 0 0 
9 2 0 0 8 13 0 0 11 0 12 3 0 14 4 0 
1 0 0 0 0 5 14 12 0 16 9 0 7 10 0 13 
5 13 0 4 0 0 2 7 8 10 15 14 0 12 0 9 
