16
6 12 3 9 5 14 0 4 0 0 1 0 10 0 16 15 
4 0 0 11 9 8 15 16 6 0 0 10 12 0 0 2 
0 0 0 10 3 11 7 0 9 0 16 0 0 0 8 0 
0 0 13 0 0 0 10 12 0 0 0 4 0 0 3 7 
0 16 0 2 11 0 8 0 0 10 0 9 3 1 0 0 
0 0 15 0 16 0 0 0 0 1 2 0 0 0 0 0 
0 10 0 0 13 0 2 0 0 4 7 14 0 6 0 11 
11 0 6 0 14 0 1 7 8 15 12 0 16 2 0 0 
3 0 4 12 0 7 11 10 0 0 0 2 0 0 13 0 
0 0 9 14 0 0 6 3 0 0 0 0 2 0 0 8 
13 0 16 0 15 0 0 0 0 11 4 0 0 0 0 0 
2 11 0 1 0 5 16 13 14 8 0 6 0 7 0 3 
10 13 0 0 7 9 0 0 12 3 0 1 8 0 0 0 
8 5 0 0 2 0 0 0 4 9 10 15 7 3 0 0 
0 3 0 0 10 13 14 5 0 6 0 16 0 9 2 0 
0 0 0 4 0 0 0 8 5 0 13 0 11 0 0 16 
