16
12 0 0 0 11 8 0 0 0 0 3 0 6 9 13 0 
13 0 3 0 0 0 7 0 0 0 0 0 0 8 1 2 
0 10 0 6 12 0 0 0 0 0 14 0 0 16 11 0 
5 8 0 0 0 9 15 0 0 0 0 0 0 0 10 4 
11 16 0 9 0 5 0 12 0 14 0 0 0 1 0 13 
8 0 13 0 0 10 0 7 16 0 2 1 0 3 4 0 
14 0 4 0 13 1 6 0 8 0 11 3 0 12 9 7 
2 3 0 0 9 0 8 0 7 12 0 13 11 6 0 10 
10 0 0 0 0 0 0 11 4 0 6 12 0 0 0 0 
6 0 2 16 0 7 0 0 11 13 0 5 0 4 12 8 
15 13 12 0 0 6 4 0 10 3 0 14 1 2 0 0 
0 0 11 3 8 0 0 13 0 0 16 7 10 5 14 6 
0 2 15 0 0 0 13 1 9 0 0 0 0 0 16 12 
0 9 0 11 0 4 0 0 0 8 0 2 0 15 0 3 
0 0 10 0 2 12 0 15 0 16 7 0 0 11 0 1 
16 0 6 4 0 0 0 0 3 0 0 15 0 0 2 0 
