16
9 0 1 0 2 0 0 0 11 15 0 0 3 5 0 0 
0 4 10 0 14 7 0 8 2 0 0 0 16 15 13 0 
6 14 0 16 13 9 15 12 1 5 0 7 11 0 0 0 
2 0 0 0 4 0 0 0 14 0 3 13 0 0 6 9 
0 16 0 1 0 0 12 0 0 0 14 10 9 0 11 0 
0 3 2 0 7 14 4 0 5 8 9 0 12 16 0 6 
0 0 11 6 8 0 0 10 15 12 13 2 0 0 0 0 
15 12 0 0 0 0 0 0 3 4 0 1 0 0 0 2 
7 0 13 0 0 8 0 3 9 6 0 0 0 12 2 15 
11 1 0 14 10 0 0 0 16 3 0 0 0 0 0 8 
0 0 15 0 5 1 2 0 0 0 0 0 0 0 3 16 
0 0 0 2 6 0 0 4 0 11 12 0 0 10 0 0 
0 0 0 3 12 16 0 2 4 0 0 0 0 1 0 10 
0 0 0 0 0 4 5 0 0 13 11 0 6 0 0 0 
16 7 9 8 0 0 10 0 12 0 5 0 4 13 0 11 
4 0 12 10 11 13 0 0 0 1 15 6 2 0 16 0 
