16
4 0 0 9 10 2 3 5 0 7 0 6 11 8 1 0 
0 0 0 11 8 0 0 12 0 0 13 0 15 16 0 6 
5 13 0 0 15 16 0 1 0 0 0 0 0 0 3 14 
0 3 0 0 0 0 0 0 0 2 14 16 0 10 4 0 
0 0 0 0 4 0 2 11 0 0 5 15 0 0 0 0 
14 0 0 7 0 8 15 16 13 11 0 0 9 4 0 10 
6 0 13 15 0 0 14 0 9 8 10 0 0 1 0 0 
0 0 16 3 0 5 0 0 14 6 0 0 0 13 0 0 
12 7 0 13 3 0 5 0 4 0 8 9 16 15 14 2 
0 8 5 16 2 15 7 14 6 0 11 0 0 0 0 1 
0 0 0 0 11 4 16 0 0 0 0 14 0 6 0 0 
0 0 4 6 13 0 0 0 0 15 7 0 0 11 0 5 
8 10 1 0 0 0 0 15 2 13 4 3 0 0 7 9 
0 12 15 0 5 9 8 4 0 14 6 10 1 0 0 0 
0 6 7 0 0 3 0 0 0 9 0 11 0 0 15 4 
9 0 3 0 0 0 6 0 0 0 16 5 0 0 0 0 
