16
0 5 16 0 13 3 0 0 0 0 0 0 4 7 0 8 
0 0 9 0 0 7 8 0 14 16 0 3 6 0 5 0 
8 7 12 10 0 6 0 0 4 0 0 0 0 0 0 0 
3 0 0 14 0 0 0 0 0 7 2 8 0 0 0 10 
0 11 0 8 12 0 5 0 2 9 0 0 16 0 14 1 
9 0 15 16 0 0 0 7 0 0 10 0 0 5 0 0 
0 13 0 1 8 0 10 3 7 0 16 4 0 0 0 15 
10 2 3 12 6 0 15 0 0 0 1 13 0 4 0 0 
1 0 0 5 7 13 0 15 6 0 0 14 9 2 0 12 
0 0 0 0 14 0 0 0 0 0 9 0 0 1 0 5 
12 14 0 15 0 0 6 9 1 0 0 0 11 8 13 0 
0 0 0 0 0 8 12 1 0 0 15 0 14 0 0 0 
0 10 6 0 9 0 7 8 12 0 14 0 3 16 4 11 
0 0 14 9 0 16 2 0 3 10 0 0 5 12 8 0 
0 0 11 0 10 12 3 4 9 13 8 0 1 0 0 6 
7 0 0 3 11 5 0 0 0 6 4 0 10 15 0 0 
