16
2 0 0 0 0 0 15 0 0 1 5 9 11 0 0 12 
5 11 0 0 9 0 4 0 13 2 12 0 7 15 10 0 
9 15 12 3 0 10 0 0 11 0 0 0 4 0 6 0 
0 4 8 7 3 12 14 11 6 16 15 10 5 13 0 0 
16 0 0 0 6 13 2 0 0 12 0 11 0 7 0 5 
0 7 9 11 4 0 3 0 0 15 1 5 14 6 0 2 
0 0 3 2 0 15 16 9 0 13 7 0 0 0 0 0 
0 0 13 15 5 1 12 7 14 4 0 2 0 11 3 0 
0 9 1 0 14 0 0 0 0 0 0 0 3 0 0 6 
13 0 2 0 7 0 8 0 0 9 0 16 0 0 11 0 
0 10 0 0 0 6 9 12 0 0 0 0 0 0 0 7 
15 0 6 0 0 0 0 0 7 0 11 8 0 0 0 0 
3 2 15 0 0 0 0 8 0 0 16 12 10 5 0 11 
4 0 5 0 12 3 7 2 15 0 0 0 6 9 0 13 
0 0 11 12 0 0 0 0 5 0 0 0 0 0 0 0 
6 13 0 0 0 0 0 0 0 0 2 14 12 0 1 15 
