16
5 0 0 8 0 0 12 0 0 13 15 0 6 4 2 9 
6 0 0 0 0 0 9 15 1 5 10 2 7 0 11 0 
9 12 1 0 0 3 2 0 16 4 0 6 5 15 10 0 
0 0 2 15 0 0 0 0 11 9 0 0 16 0 1 8 
16 0 0 0 5 0 1 0 6 15 0 13 0 0 0 10 
15 0 0 12 8 9 10 6 4 0 0 0 14 16 0 5 
13 1 4 0 0 15 0 2 0 8 16 9 0 0 3 0 
0 0 0 0 7 16 13 0 0 0 5 12 0 1 0 0 
12 0 0 1 15 0 8 0 0 2 0 0 0 0 0 16 
0 8 15 0 0 2 3 9 12 0 7 0 0 10 0 0 
11 0 0 0 0 7 5 14 0 16 3 0 2 0 4 0 
3 5 14 2 0 12 16 0 0 6 1 0 0 13 15 7 
0 0 0 0 0 0 11 0 8 10 0 4 15 6 0 0 
8 14 12 11 9 0 0 0 2 3 0 1 0 0 16 0 
1 0 0 0 0 5 4 0 0 0 0 15 0 0 0 2 
0 15 0 0 0 1 0 0 5 0 13 0 0 11 0 0 
