16
8 0 0 0 0 0 3 0 16 0 1 15 0 4 12 10 
0 0 0 0 0 0 8 0 6 7 4 10 0 13 0 0 
0 0 0 0 0 0 0 4 0 0 0 0 14 8 0 0 
4 0 7 0 0 12 0 9 8 5 14 13 16 0 0 2 
0 8 0 0 0 0 14 0 0 0 10 16 0 7 6 13 
0 10 0 0 0 0 0 11 0 12 7 0 3 14 0 0 
2 13 14 0 12 6 1 0 3 9 0 4 0 11 0 0 
7 3 0 0 0 9 0 10 13 14 2 0 8 0 0 0 
0 11 0 12 6 8 9 0 5 0 0 0 0 0 3 0 
6 2 0 0 7 5 12 15 9 0 13 14 0 0 4 0 
0 9 0 15 0 10 0 0 0 0 0 0 5 2 0 6 
5 0 0 14 0 1 2 16 0 6 3 8 0 15 0 9 
0 0 2 0 0 15 0 0 0 0 11 0 13 5 0 0 
13 1 6 0 0 14 0 12 4 8 16 0 0 0 11 3 
0 16 9 5 10 13 0 0 0 15 6 0 4 0 14 12 
0 0 15 0 3 11 4 1 10 13 5 0 0 6 0 8 
