16
10 13 8 0 0 14 0 9 0 5 0 2 0 7 0 4 
0 0 0 0 16 13 15 0 0 6 4 14 3 0 8 0 
1 3 0 0 0 2 0 11 0 16 0 7 0 10 0 0 
14 2 0 6 7 1 0 0 0 10 8 0 0 0 11 0 
0 14 15 0 0 0 9 0 0 0 1 0 16 0 0 0 
3 0 0 0 11 5 0 0 9 8 7 0 0 14 0 15 
5 0 0 0 0 0 0 1 11 0 16 6 8 9 10 0 
16 11 9 0 0 0 7 8 0 0 0 15 1 5 0 13 
0 15 0 0 0 10 16 0 8 4 6 3 0 0 0 0 
4 0 0 3 8 9 6 0 0 0 0 0 15 0 0 10 
6 0 0 0 14 0 5 3 16 7 13 0 11 0 0 0 
0 0 14 0 4 0 0 13 0 0 0 1 7 3 0 0 
13 0 0 11 0 4 0 6 7 9 0 8 0 0 15 16 
8 16 3 12 0 7 0 5 0 0 15 0 10 1 9 6 
15 0 0 0 0 0 10 0 2 0 3 16 0 0 5 0 
7 10 1 14 0 16 0 15 6 13 0 12 0 0 4 0 
