16
11 1 0 0 0 4 0 5 0 0 0 10 9 15 12 14 
0 3 10 0 12 6 11 0 0 7 16 9 0 5 2 4 
15 0 0 4 0 13 0 8 3 0 12 14 6 0 7 0 
12 2 0 16 14 15 0 7 4 0 0 5 1 13 10 3 
10 9 0 0 7 0 0 4 0 0 6 15 5 0 0 0 
16 0 2 0 10 0 0 0 0 0 5 0 0 8 0 0 
7 0 0 0 1 0 0 2 11 9 0 12 16 10 0 15 
0 4 0 0 3 16 15 0 0 8 0 0 0 0 0 12 
0 12 3 2 5 1 16 0 0 0 15 13 0 6 8 10 
0 0 16 0 0 3 6 0 0 11 4 0 0 0 0 0 
13 7 0 8 0 0 0 14 0 0 0 0 2 3 0 11 
0 0 11 0 15 0 0 0 0 5 3 8 4 0 0 0 
0 0 14 0 0 0 0 12 7 15 13 4 0 0 0 8 
0 0 4 7 13 10 1 15 0 0 0 16 0 14 9 0 
9 0 0 12 0 2 0 0 0 0 0 11 15 0 0 13 
2 0 13 0 11 0 7 16 0 0 0 6 0 0 1 0 
