16
16 0 10 0 0 0 7 3 0 1 0 0 0 0 14 0 
8 11 0 5 0 0 0 0 0 0 13 0 0 0 3 4 
0 7 14 3 0 5 0 0 0 4 0 0 6 1 8 13 
0 1 4 0 0 8 12 0 7 3 0 0 11 0 0 10 
14 0 0 6 0 16 11 0 0 0 2 1 9 0 13 0 
0 0 0 7 0 0 5 10 0 15 14 11 0 12 0 16 
1 5 0 11 0 14 13 12 16 0 7 4 0 2 10 6 
4 2 16 0 0 1 15 8 13 0 0 0 14 11 0 5 
15 0 0 14 0 7 0 0 0 6 0 8 0 0 9 0 
0 4 11 2 0 13 6 0 12 0 1 0 0 0 0 14 
0 0 0 16 12 11 0 15 14 5 9 0 3 0 0 0 
0 0 12 1 0 0 0 14 0 16 0 0 7 0 0 11 
0 0 7 0 4 0 10 1 0 0 0 0 0 9 0 0 
6 0 13 0 0 0 0 7 0 0 0 10 5 0 12 0 
10 3 0 0 0 12 0 0 0 2 15 5 0 0 6 0 
11 9 2 8 5 6 3 13 4 0 0 0 16 10 1 15 
