16
6 1 0 13 9 16 5 7 12 11 14 15 0 10 3 4 
0 0 16 0 2 0 0 11 4 0 0 3 0 15 12 0 
0 4 11 0 0 0 10 0 0 0 1 6 0 0 9 7 
5 0 0 0 0 13 0 0 0 2 0 9 16 0 14 11 
13 0 10 5 0 4 0 8 0 16 15 0 7 12 0 0 
0 0 0 16 10 0 12 0 13 0 5 14 0 0 0 0 
0 0 4 8 5 0 7 0 3 10 0 0 0 16 0 0 
1 14 9 3 13 15 0 16 0 12 0 0 0 0 10 0 
0 15 12 1 0 0 0 0 7 8 0 13 0 0 0 0 
0 0 3 0 0 12 14 0 0 6 16 0 9 0 2 1 
0 5 0 0 7 0 0 0 2 14 9 0 12 4 0 0 
0 16 2 0 1 0 0 0 0 0 0 0 0 0 0 8 
9 0 6 0 4 0 0 1 5 0 0 16 14 2 15 10 
16 13 5 0 14 7 9 2 1 15 0 10 8 3 6 0 
0 3 1 0 16 0 0 0 14 0 0 0 0 0 4 0 
4 8 0 0 0 11 15 13 0 0 0 0 1 9 0 0 
