16
9 2 0 16 0 0 1 15 0 0 0 14 0 0 0 7 
0 0 10 0 4 8 0 0 0 9 0 1 2 14 0 0 
14 0 0 15 10 13 0 0 16 0 0 3 0 8 0 0 
7 8 0 0 2 0 3 9 0 0 15 0 0 0 5 0 
11 15 0 3 13 7 6 0 0 16 4 0 10 0 0 5 
6 0 1 0 0 9 0 5 10 8 3 11 12 2 7 15 
5 10 9 0 15 1 2 0 7 14 0 0 3 0 0 8 
0 16 0 8 0 11 0 0 15 0 9 5 13 0 0 6 
1 7 0 0 0 6 13 2 0 3 0 12 0 0 0 0 
0 0 0 0 11 0 0 12 1 6 0 0 0 0 3 10 
0 11 15 0 7 0 5 0 9 0 0 0 0 0 8 13 
13 6 0 5 0 16 4 14 8 11 10 15 0 0 0 0 
15 0 0 0 0 12 0 13 2 7 0 16 8 0 11 3 
0 0 0 0 0 10 0 6 0 0 0 9 15 12 13 14 
16 0 12 11 8 0 0 0 0 13 0 10 5 9 0 1 
0 0 0 0 0 2 0 0 3 15 0 0 0 0 0 0 
