16
11 4 0 7 0 0 0 0 0 14 0 3 10 0 16 0 
0 0 0 5 0 14 0 0 0 0 4 10 0 8 0 15 
0 12 0 15 3 0 10 0 0 0 0 11 0 0 0 0 
10 0 1 6 0 0 0 5 8 0 0 0 0 11 3 12 
1 0 12 9 0 10 2 14 0 0 0 0 0 3 0 16 
0 11 0 0 0 5 0 16 12 6 0 7 13 0 0 2 
0 7 0 3 4 0 0 0 15 2 11 0 5 0 10 0 
0 0 15 8 13 0 0 3 0 0 0 16 4 0 12 6 
3 16 5 2 0 13 1 11 0 15 9 0 0 4 0 10 
0 14 0 0 5 15 16 2 3 10 0 0 9 6 0 13 
9 0 0 0 0 3 12 10 0 0 0 14 0 15 5 0 
0 15 8 10 0 7 14 4 0 0 0 0 0 0 2 3 
7 0 2 0 14 1 0 0 0 8 0 0 3 12 0 0 
5 3 6 16 10 8 0 0 0 0 7 0 2 14 13 0 
14 0 4 12 0 0 3 15 0 0 2 0 0 0 9 0 
15 1 9 13 0 0 5 7 11 3 0 0 0 0 0 0 
