16
15 10 11 13 0 6 8 3 0 0 9 2 0 4 16 7 
0 1 0 0 10 7 0 0 8 6 0 15 0 12 0 9 
6 0 7 0 0 0 1 5 13 0 0 11 0 3 14 0 
0 0 2 3 0 0 0 14 0 0 16 0 0 15 8 0 
8 9 15 0 0 0 0 0 4 11 0 7 0 0 12 0 
0 0 16 0 4 0 15 13 5 8 0 9 6 7 3 1 
2 14 0 0 16 8 10 0 0 0 0 3 0 0 0 0 
13 0 0 0 7 0 0 9 16 14 0 0 8 2 10 0 
0 0 6 0 0 0 0 0 0 1 0 13 0 0 2 12 
9 13 0 14 1 15 0 12 11 0 7 0 3 0 6 8 
0 12 8 1 0 10 2 0 15 3 14 0 11 16 0 0 
0 0 0 4 0 13 0 0 9 12 0 16 14 1 7 15 
4 0 0 0 0 0 0 6 0 0 13 0 0 0 0 5 
0 0 0 2 0 0 14 16 7 10 0 0 0 8 15 3 
0 0 0 10 5 1 9 0 0 0 0 0 12 6 0 0 
0 3 13 0 0 2 12 10 6 9 0 0 0 0 0 0 
