16
0 0 11 12 7 14 2 0 0 13 3 0 0 0 0 4 
0 0 0 7 11 0 15 16 4 0 0 2 0 0 5 14 
0 8 0 10 9 0 0 1 15 0 0 7 0 0 0 0 
16 0 15 14 0 4 3 0 0 0 8 0 11 7 10 0 
15 13 14 0 0 10 0 9 16 8 0 0 1 0 0 12 
0 10 1 0 0 3 13 0 0 4 0 0 0 0 0 5 
3 0 16 5 15 2 0 0 0 0 13 0 0 4 0 0 
8 0 0 0 12 0 0 0 3 9 11 0 0 0 0 0 
0 0 0 0 3 7 10 15 14 0 0 0 6 0 0 0 
14 0 0 0 13 0 4 8 7 0 0 0 0 0 2 11 
2 6 9 0 14 0 16 12 8 10 0 13 4 0 0 0 
0 7 0 13 2 1 9 6 0 16 15 4 5 12 0 0 
7 0 6 16 8 0 0 0 10 15 0 3 0 5 0 0 
0 0 2 9 1 0 0 0 0 5 16 8 0 0 0 7 
1 14 10 3 0 0 0 0 9 2 0 0 15 8 4 0 
5 0 8 4 10 0 6 3 13 7 0 0 0 9 12 0 
