16
1 0 0 3 13 6 10 11 4 0 12 0 9 0 0 5 
13 8 10 11 0 9 1 0 6 3 5 0 12 0 2 0 
0 6 0 0 2 0 3 12 8 9 13 0 11 10 1 0 
0 9 2 0 7 5 15 8 0 0 0 11 0 0 0 3 
0 13 7 0 5 12 0 0 0 0 0 0 15 2 3 14 
14 15 0 1 9 0 0 3 2 0 10 5 0 0 0 6 
0 0 0 0 0 0 0 0 0 6 0 4 0 5 9 0 
0 5 6 0 0 2 8 0 0 0 3 13 7 11 0 0 
15 0 0 8 10 1 0 0 7 0 0 14 0 0 16 13 
2 0 0 6 0 0 7 14 1 11 9 0 0 0 12 4 
12 7 5 0 11 4 0 0 0 10 0 0 0 0 8 0 
3 0 0 14 0 0 9 0 0 15 6 0 0 0 0 0 
0 0 0 5 4 0 0 9 0 0 8 10 2 12 15 11 
0 0 14 0 6 0 0 7 0 0 1 3 0 0 10 0 
7 0 3 9 0 10 0 13 12 4 11 0 0 1 14 0 
0 16 0 0 0 0 0 0 14 0 0 0 0 6 5 0 
