16
12 0 6 8 3 0 9 10 11 0 0 14 16 2 4 5 
14 9 3 0 0 0 13 0 0 12 0 0 0 0 0 1 
2 11 0 0 0 0 0 0 6 0 7 16 9 8 0 12 
16 0 1 0 12 0 2 0 13 0 0 0 0 15 0 11 
0 0 2 13 0 10 0 7 9 0 0 0 12 0 6 0 
0 0 4 3 0 6 12 5 0 13 16 15 2 9 0 7 
1 6 0 0 0 0 0 16 2 7 0 0 0 0 0 15 
0 7 0 5 0 3 0 2 0 8 0 1 0 13 0 4 
0 0 9 14 6 0 0 0 0 1 0 13 0 0 5 0 
0 0 0 1 0 0 0 0 0 6 0 10 13 0 11 16 
0 10 0 12 0 1 0 3 0 5 0 0 0 0 0 9 
0 15 0 0 10 0 5 9 0 14 0 4 8 0 1 0 
0 14 0 11 2 0 0 0 0 10 15 0 4 5 0 0 
9 1 15 6 5 0 7 13 0 0 0 0 10 3 2 0 
5 0 13 10 11 0 0 8 1 2 0 0 0 0 0 6 
3 12 0 2 4 16 10 0 0 9 0 6 1 11 0 0 
