16
0 0 2 4 0 0 11 0 9 14 15 0 12 0 1 16 
0 0 10 0 0 0 0 0 5 0 0 7 0 0 6 0 
0 15 6 0 8 1 0 5 10 2 11 16 0 3 4 13 
0 0 3 1 6 0 0 7 13 0 0 4 10 0 5 2 
0 14 0 0 13 0 1 12 0 0 0 8 15 6 0 9 
1 0 12 0 0 0 8 0 14 5 0 0 16 10 13 0 
8 0 0 9 4 6 3 0 11 12 0 15 0 14 2 0 
16 0 15 0 9 0 0 14 0 0 0 0 0 0 0 0 
2 12 0 0 0 8 0 6 0 0 0 0 0 9 0 5 
0 5 0 0 12 0 14 9 0 0 2 0 0 0 0 10 
3 1 4 14 16 10 0 0 12 15 9 0 7 0 0 0 
0 0 0 0 0 2 0 0 8 6 0 5 0 0 0 3 
10 2 5 8 11 0 0 0 1 16 7 12 0 0 15 0 
7 4 16 11 0 12 6 0 2 3 13 0 0 0 0 1 
12 3 14 0 1 0 16 8 15 0 5 0 0 0 0 11 
0 0 0 15 0 0 0 2 0 4 8 0 3 0 10 0 
