16
11 16 8 0 0 0 0 9 4 0 0 0 5 1 0 0 
0 0 0 9 8 0 11 0 1 7 0 2 12 0 0 0 
10 0 0 0 1 0 13 15 16 9 11 0 3 0 0 8 
3 4 1 7 0 0 0 5 0 0 8 0 0 0 14 11 
0 8 0 0 0 0 0 0 11 0 4 0 0 7 0 0 
15 0 5 4 0 0 10 11 0 0 6 16 0 0 0 13 
0 13 7 1 15 5 0 0 0 10 0 0 0 4 2 16 
0 3 11 0 0 0 16 1 5 8 13 7 15 12 0 9 
16 12 13 0 6 0 0 0 0 0 1 0 0 0 0 0 
0 1 0 0 12 0 15 8 0 0 0 0 0 0 4 3 
0 15 0 0 0 2 0 16 0 0 9 0 10 0 0 14 
0 9 0 0 0 3 0 13 0 16 5 12 0 8 0 1 
5 7 4 0 2 10 0 0 9 0 0 3 1 14 8 0 
1 10 3 0 11 0 9 7 0 0 0 0 13 2 6 0 
8 11 0 14 13 15 3 0 6 5 2 1 0 16 9 10 
2 0 9 0 0 1 0 0 7 0 0 0 4 0 3 0 
