16
0 0 2 0 15 0 9 0 0 10 8 0 7 16 1 0 
11 13 7 0 0 6 4 0 0 0 1 15 0 0 10 9 
10 1 8 9 0 16 7 12 0 0 0 4 0 0 15 0 
15 0 0 14 0 8 0 1 0 7 0 0 2 11 12 0 
0 7 0 4 6 0 0 0 14 8 15 16 0 0 0 2 
12 10 15 0 5 0 0 9 1 0 2 0 0 0 0 8 
0 11 14 0 0 2 13 15 6 0 0 10 0 0 0 7 
0 0 3 0 0 4 8 16 0 13 12 11 0 6 0 0 
0 3 0 15 4 12 11 0 0 0 0 0 9 10 0 14 
0 14 0 12 0 13 0 8 3 6 0 0 0 4 0 5 
0 4 6 8 0 0 0 0 10 11 14 0 15 0 2 0 
1 0 0 11 14 0 16 0 0 5 0 2 0 8 3 0 
0 0 0 0 16 0 1 5 0 15 11 8 12 0 13 0 
4 0 0 0 0 0 0 0 7 16 10 0 6 15 8 3 
3 0 11 0 8 0 0 0 12 14 0 0 16 9 0 1 
16 0 0 10 12 15 0 7 2 0 0 3 5 0 0 0 
