16
0 2 0 0 11 0 4 0 0 0 0 0 9 0 0 0 
0 8 14 1 15 2 12 10 13 3 11 5 16 0 0 7 
16 12 0 0 0 13 3 6 4 9 0 0 15 1 10 2 
0 4 3 0 0 0 0 9 0 10 0 1 0 0 11 8 
0 0 9 16 4 5 0 14 10 2 15 12 0 0 6 0 
11 6 0 0 0 0 15 13 0 1 14 0 0 8 5 0 
0 0 0 12 10 9 0 0 6 11 0 0 14 0 15 0 
0 3 7 14 0 6 0 0 8 4 5 0 13 2 0 10 
7 14 0 8 6 0 0 0 0 12 0 0 0 0 9 0 
12 0 2 0 9 0 0 0 7 13 0 3 0 10 14 0 
0 16 0 0 7 0 0 12 0 8 0 14 0 0 0 0 
0 11 6 0 16 0 0 0 0 15 0 10 5 12 0 0 
5 0 16 0 0 14 6 0 0 0 10 0 2 0 0 0 
0 0 15 2 13 1 9 11 12 0 3 8 10 0 16 6 
0 0 12 0 0 16 0 7 9 5 1 0 0 11 8 0 
0 0 0 0 0 0 0 0 0 6 0 2 3 7 0 0 
