16
2 0 6 7 1 14 0 9 4 10 0 12 0 15 0 0 
3 0 14 0 15 0 0 7 6 1 0 5 0 4 9 11 
0 15 0 0 11 6 5 0 0 0 0 3 0 7 8 2 
0 0 0 9 0 4 13 0 0 8 0 2 16 0 0 6 
0 12 0 16 0 0 0 14 0 2 0 0 15 11 0 0 
0 6 1 0 0 0 10 13 14 0 5 0 9 16 0 0 
10 0 0 0 0 5 0 11 8 0 0 0 12 1 0 4 
0 3 0 11 16 8 4 0 0 0 0 0 0 0 2 0 
9 7 0 0 13 0 0 4 0 0 8 10 2 14 1 5 
0 14 0 0 0 11 0 0 2 0 0 6 0 0 4 7 
5 0 0 0 7 0 0 1 3 13 0 0 0 6 16 12 
0 1 2 0 0 0 0 0 5 0 0 7 0 0 0 15 
13 0 0 8 12 7 1 16 10 5 0 14 4 0 0 0 
0 0 0 0 0 0 11 0 0 0 16 4 0 3 12 14 
0 4 16 5 0 15 0 0 0 12 0 9 7 10 13 1 
12 0 7 0 4 10 14 2 0 0 3 0 0 5 11 0 
