16
8 0 7 0 0 0 0 0 12 5 0 0 15 10 0 1 
12 0 5 11 0 0 0 1 7 6 0 10 16 0 0 0 
6 1 3 0 7 0 5 10 0 16 0 0 0 0 4 2 
0 0 9 10 8 0 11 14 2 15 1 13 0 5 0 0 
9 13 12 0 4 0 8 2 0 0 3 0 0 0 10 0 
3 7 8 4 0 10 0 0 16 0 5 0 0 0 2 0 
2 0 11 0 0 0 12 5 8 4 0 0 0 3 0 0 
0 5 0 0 0 0 0 13 10 0 0 2 0 0 16 9 
15 0 1 3 2 13 7 0 0 0 8 16 10 0 0 5 
0 0 0 5 0 0 6 0 4 0 0 0 0 1 0 8 
4 0 0 9 10 16 0 8 15 3 2 0 0 0 0 0 
0 0 0 8 5 14 0 0 0 10 13 0 0 15 3 16 
0 9 0 0 0 4 10 0 6 0 7 1 0 2 0 0 
0 0 0 7 0 1 16 9 5 0 15 4 0 0 11 0 
0 0 0 2 12 8 0 3 0 9 16 0 0 7 0 10 
11 0 6 0 0 5 2 0 3 14 0 0 9 16 0 4 
