16
13 0 8 0 9 6 7 0 5 0 0 0 2 0 3 0 
0 0 6 0 0 0 5 0 0 7 0 13 12 8 0 10 
0 0 3 10 0 0 15 12 6 0 0 11 9 16 7 0 
15 0 0 0 13 1 0 0 2 3 9 4 14 0 6 0 
0 0 0 0 0 0 9 0 0 16 10 6 0 0 13 0 
0 0 0 14 6 5 0 0 12 2 15 0 4 10 0 0 
16 0 5 0 0 0 0 0 8 0 0 1 7 0 9 0 
12 13 0 4 0 16 0 14 0 11 0 0 15 0 0 3 
0 0 0 8 0 0 11 3 13 1 2 0 10 15 0 0 
7 0 4 0 12 14 6 9 11 15 3 0 16 0 0 0 
2 11 1 13 5 0 16 0 7 0 14 0 3 0 12 8 
0 0 0 16 2 8 1 13 10 0 4 0 6 0 11 9 
0 0 14 0 0 13 4 1 0 0 0 15 11 2 0 12 
0 5 11 12 10 9 0 0 0 0 8 2 1 0 15 0 
0 16 0 15 7 2 0 0 0 0 11 12 0 0 0 0 
6 0 0 0 0 0 0 11 0 10 0 0 0 0 5 0 
