16
16 0 15 0 0 0 0 0 0 0 0 0 0 4 10 0 
0 0 6 0 11 3 0 0 7 8 0 4 1 0 0 2 
0 14 7 9 0 6 0 0 15 0 3 0 0 0 0 11 
0 4 0 11 13 0 0 2 0 16 0 5 0 0 9 0 
1 0 0 12 2 4 0 11 0 0 0 0 5 7 14 0 
14 3 0 0 0 0 0 0 0 7 0 11 0 8 0 0 
6 13 5 7 0 0 14 0 0 4 0 10 11 0 2 15 
0 2 0 0 7 8 1 0 5 13 6 0 0 0 0 0 
4 11 0 13 5 7 2 0 0 0 0 8 0 15 0 16 
15 6 0 0 0 0 4 13 0 2 0 0 0 0 0 5 
0 0 2 0 0 0 0 0 0 6 0 0 13 3 7 4 
10 0 0 5 15 0 3 6 0 11 0 13 0 9 8 0 
0 10 11 3 4 0 16 5 6 9 8 1 12 0 15 14 
5 12 8 4 1 10 7 15 0 0 0 3 0 0 16 9 
0 15 0 0 0 0 6 14 4 10 0 0 0 11 0 3 
0 0 0 6 3 13 0 8 0 0 15 12 7 10 0 1 
