16
9 1 0 13 0 15 3 0 2 0 0 10 5 0 4 8 
0 8 10 0 16 0 0 0 12 9 0 0 0 2 0 0 
4 0 14 0 0 0 0 2 0 0 8 0 0 0 16 0 
16 0 2 3 13 0 0 0 0 0 0 14 1 10 15 0 
0 0 0 0 0 0 0 0 3 0 14 0 2 6 11 7 
0 0 0 11 7 12 0 0 0 2 4 0 0 0 0 1 
6 16 8 12 5 0 0 1 10 15 7 0 0 4 13 3 
7 0 0 10 0 13 14 3 0 0 1 0 0 0 0 0 
0 10 7 9 6 0 0 14 5 4 11 0 0 13 2 0 
0 11 6 4 15 0 0 0 14 13 0 2 0 1 3 5 
0 0 0 16 1 0 4 0 0 8 0 0 0 0 0 0 
14 13 0 2 0 0 11 5 0 16 3 15 4 0 6 0 
11 0 0 0 2 0 10 8 9 0 0 13 0 0 0 4 
0 3 0 0 11 0 5 0 16 10 2 0 0 7 8 9 
10 0 0 0 14 0 16 12 6 3 0 7 13 11 0 0 
0 0 16 1 0 9 0 0 0 11 5 4 0 15 12 0 
