16
0 8 15 0 14 0 0 4 0 0 2 12 0 0 0 5 
6 0 0 0 16 0 0 13 0 0 0 0 0 0 0 4 
10 0 5 2 0 0 0 0 0 0 6 0 0 0 7 0 
4 0 13 0 0 10 0 0 3 0 0 16 6 8 0 0 
5 13 0 16 11 8 6 15 0 0 0 14 3 0 0 0 
12 0 1 8 9 4 7 16 0 13 3 10 5 6 0 0 
0 0 6 3 1 14 10 5 7 0 0 11 12 2 0 16 
0 0 7 0 0 3 2 12 0 0 0 6 0 1 9 0 
9 0 10 15 2 0 0 0 0 0 0 8 0 11 5 0 
0 0 0 0 0 9 4 1 0 10 11 0 7 0 6 12 
7 0 0 0 0 0 0 3 9 0 13 1 14 16 0 0 
1 0 12 4 10 16 5 0 14 0 7 0 8 9 3 13 
8 0 0 1 0 5 0 9 0 3 0 0 0 0 0 0 
3 5 0 12 0 1 8 0 11 0 10 7 0 13 0 2 
2 0 0 10 0 11 16 0 12 15 5 0 0 7 8 3 
13 0 0 6 3 0 0 10 0 1 0 0 0 0 0 0 
