16
0 0 0 0 11 0 8 0 15 0 0 12 0 0 16 0 
5 15 0 14 16 4 0 9 0 0 0 0 1 0 0 0 
9 7 0 8 0 0 0 6 0 16 0 14 0 0 0 5 
16 0 0 0 0 0 2 3 0 0 0 9 0 7 0 15 
12 13 4 1 0 8 10 11 2 9 0 6 0 0 7 14 
8 0 0 6 14 16 0 12 7 0 11 13 2 9 4 3 
7 0 0 0 0 0 0 2 12 0 8 4 11 6 0 10 
0 0 0 0 0 6 7 0 5 0 0 16 0 0 0 0 
0 0 9 0 0 1 14 16 3 13 0 0 8 0 0 7 
6 4 0 10 2 0 15 0 16 14 0 1 0 0 3 13 
1 12 5 3 6 10 0 0 0 2 0 0 16 0 0 0 
14 0 13 0 0 12 0 0 0 11 15 0 0 0 0 2 
10 11 2 4 0 0 6 15 0 12 0 3 0 8 0 16 
0 0 14 0 5 2 0 1 13 0 0 8 0 0 0 0 
0 0 0 5 0 3 0 14 0 4 2 11 0 0 0 1 
0 0 0 12 8 9 11 10 14 0 0 15 7 3 0 4 
