16
16 13 6 0 0 5 10 0 0 0 0 0 7 0 0 9 
0 0 11 0 6 1 15 8 5 0 0 9 0 0 0 0 
15 9 10 1 0 0 2 11 0 3 16 0 6 0 5 12 
0 5 0 2 7 16 9 4 0 10 6 0 14 0 1 11 
0 0 2 0 11 0 0 7 0 0 4 0 0 0 9 13 
1 16 14 0 0 0 12 0 0 0 7 13 3 0 15 0 
7 0 0 12 0 3 13 0 2 0 0 0 0 11 0 5 
0 6 9 11 0 0 0 0 16 12 3 10 1 14 0 0 
0 0 0 0 0 0 7 0 0 0 0 5 11 10 0 0 
0 2 7 10 15 0 6 0 0 9 1 11 0 0 0 0 
0 0 1 15 9 0 0 0 0 7 0 0 0 0 0 16 
6 0 0 3 0 10 8 5 4 0 0 2 9 7 0 15 
0 0 0 0 5 4 0 6 0 11 15 12 13 9 16 14 
14 4 5 0 0 2 0 0 0 0 8 0 15 0 0 7 
9 0 0 0 8 0 16 14 0 6 2 7 0 0 0 0 
0 10 15 0 0 7 3 9 0 0 5 0 12 2 0 8 
