16
13 0 8 5 2 0 0 0 0 1 16 11 7 0 12 0 
1 0 9 7 15 0 3 10 0 4 6 0 0 2 13 0 
0 0 2 6 0 0 4 0 0 5 14 0 8 11 0 0 
12 0 14 4 11 7 8 0 0 0 2 0 0 0 0 6 
0 0 10 9 6 0 0 3 0 0 4 0 15 0 0 0 
0 0 5 3 0 0 0 15 11 0 0 1 0 13 4 7 
4 0 0 0 10 0 1 0 3 2 0 0 0 0 0 0 
0 2 0 16 0 0 13 0 0 7 0 0 0 10 0 3 
0 0 16 0 0 6 0 4 0 11 13 9 14 0 15 2 
0 13 6 1 0 0 0 11 4 0 0 2 10 0 0 9 
0 0 4 11 14 2 0 0 6 8 1 0 12 3 16 0 
2 0 12 15 13 0 0 0 7 0 0 16 6 8 11 0 
0 6 1 14 3 15 16 13 0 0 10 0 11 0 5 12 
9 0 15 13 12 0 0 0 5 0 0 0 0 6 0 0 
0 5 7 0 9 1 6 0 13 12 0 0 0 0 10 16 
16 0 0 0 0 0 5 0 0 0 0 15 0 0 9 8 
