16
4 7 1 0 0 3 0 5 0 9 12 14 2 6 0 0 
0 0 12 15 6 0 0 0 0 0 0 0 7 0 8 9 
0 13 0 0 0 0 7 0 2 0 3 1 0 0 0 5 
0 0 0 0 2 4 10 0 0 0 7 0 12 3 1 16 
0 9 3 0 0 13 6 10 0 0 16 0 0 2 0 12 
15 2 0 7 0 16 0 1 3 0 10 4 6 9 0 0 
0 0 11 6 12 0 9 0 0 0 5 2 10 7 3 4 
0 8 0 0 0 2 0 7 6 0 0 9 16 0 13 0 
0 4 0 9 14 0 0 6 0 0 0 0 0 12 0 0 
8 1 0 0 0 5 0 3 0 2 0 0 14 10 6 0 
0 0 0 0 1 9 11 13 16 0 0 3 0 8 0 7 
7 0 5 13 0 0 0 16 0 1 0 15 9 0 0 0 
13 0 14 10 3 0 0 4 0 0 0 0 5 16 0 6 
16 0 0 0 10 11 0 0 0 15 14 6 3 0 12 8 
0 11 0 3 7 12 5 0 9 0 1 10 0 15 4 2 
9 0 4 0 16 0 0 0 0 3 0 0 0 0 7 0 
