16
0 0 3 10 0 15 0 0 0 14 9 0 4 0 2 12 
11 15 0 9 0 0 0 8 13 5 0 0 0 1 16 0 
13 16 12 4 0 5 0 0 11 1 0 0 0 0 0 3 
1 14 0 0 10 13 12 4 15 0 0 0 0 0 9 7 
12 11 6 5 7 3 9 14 0 2 0 15 0 8 0 4 
14 13 8 0 0 10 0 0 0 11 5 7 0 0 0 0 
3 10 0 0 2 0 5 11 14 0 6 16 12 0 0 13 
16 0 4 0 0 6 0 13 0 0 0 9 0 0 3 14 
0 0 11 3 5 9 13 10 16 8 1 4 7 0 0 2 
2 0 0 12 0 0 3 7 0 0 0 0 10 16 1 8 
0 0 1 0 0 0 0 0 2 0 7 0 0 0 0 0 
7 0 16 0 0 1 0 6 0 12 0 10 0 0 15 5 
0 7 15 0 13 16 0 2 0 6 3 0 0 10 12 0 
0 0 5 0 0 14 0 15 0 0 2 0 0 0 4 0 
0 0 14 2 0 0 0 5 0 0 0 11 0 0 0 15 
0 0 0 16 0 7 0 3 0 0 0 14 8 2 0 11 
