16
0 0 13 6 0 0 0 16 4 0 3 2 5 11 9 0 
0 0 3 0 0 9 8 0 7 1 0 0 15 0 0 0 
1 0 9 0 0 0 10 0 0 5 0 0 0 0 0 16 
2 0 15 16 0 0 0 5 8 0 0 0 14 3 1 13 
15 16 5 0 8 1 4 0 9 0 2 13 7 0 0 3 
7 0 0 1 15 0 3 12 0 14 0 0 0 0 0 0 
0 4 8 0 0 0 9 2 0 6 10 0 11 5 0 15 
0 3 10 12 0 14 0 6 11 0 15 7 16 0 0 2 
5 0 7 15 0 6 0 0 0 0 9 0 3 10 16 0 
6 0 12 0 3 0 15 0 0 0 0 0 13 0 5 11 
11 0 0 3 14 0 0 0 15 0 0 0 8 0 2 0 
0 14 4 0 0 0 11 13 10 3 8 0 0 0 0 0 
13 0 0 7 11 15 0 0 0 0 0 8 0 0 3 9 
0 0 14 9 0 12 0 3 6 0 7 15 0 0 11 0 
4 6 11 5 10 0 2 0 0 0 13 9 0 0 0 7 
3 0 0 10 0 0 7 0 0 11 12 14 1 8 6 0 
