16
13 0 0 4 0 0 0 0 8 2 10 0 1 0 0 0 
0 0 10 0 0 11 9 0 0 0 1 0 7 14 5 13 
0 0 0 9 13 0 0 3 12 0 0 14 0 0 0 0 
3 0 11 14 0 15 0 10 9 7 5 0 0 0 2 16 
0 0 0 0 5 0 13 0 6 12 11 0 9 3 16 0 
14 0 0 0 4 12 10 0 0 8 0 0 13 15 0 0 
0 0 0 13 0 0 3 0 0 14 9 7 8 10 1 0 
7 0 8 15 0 9 0 0 0 1 13 0 0 0 0 6 
0 14 0 0 3 10 6 0 7 0 0 0 0 11 12 4 
0 5 0 7 0 4 0 0 0 11 0 12 16 6 13 3 
0 2 9 0 11 0 0 0 3 10 16 4 0 7 0 0 
11 8 0 0 0 16 0 12 14 13 0 0 0 1 9 0 
12 1 0 0 0 0 4 0 5 9 14 0 15 2 10 8 
0 0 0 5 9 0 12 2 10 6 0 0 0 0 7 1 
0 13 7 0 0 1 0 0 0 3 0 0 4 0 0 0 
0 10 2 0 8 5 0 0 13 15 7 0 3 12 14 9 
