16
16 5 15 0 0 0 0 0 12 1 3 0 0 2 0 0 
7 0 0 4 8 0 0 11 5 0 0 0 0 6 0 9 
0 9 3 2 0 0 15 0 0 0 8 0 0 7 14 0 
6 0 8 12 14 0 0 5 0 0 9 0 0 0 0 0 
0 4 0 0 13 0 0 0 1 7 0 14 0 8 5 0 
13 0 16 7 0 5 10 0 0 0 6 11 0 14 3 0 
0 0 0 0 0 11 0 0 4 10 12 13 0 15 0 7 
14 0 6 0 1 16 0 0 9 0 0 0 11 0 4 12 
12 13 0 15 6 0 4 0 8 9 0 0 0 0 1 2 
1 16 2 11 12 13 0 0 14 15 7 3 0 0 10 4 
0 3 0 0 7 0 2 0 10 0 5 0 14 11 13 16 
0 14 0 6 11 0 3 0 13 0 1 0 0 0 0 15 
0 0 14 9 15 0 0 3 0 0 0 0 0 0 16 6 
5 0 0 13 0 8 0 6 7 16 4 0 12 3 9 14 
0 0 0 16 5 12 0 0 6 11 0 0 7 1 2 8 
0 6 0 0 0 10 0 7 0 0 0 8 0 0 0 13 
