16
0 0 0 0 0 9 2 5 0 0 0 7 1 14 0 0 
0 14 0 0 0 0 15 0 0 0 1 0 0 0 3 12 
7 5 0 8 1 11 0 12 0 15 0 10 0 13 2 0 
0 13 1 11 0 0 8 3 5 0 0 0 0 0 0 0 
5 16 6 0 14 8 4 0 0 0 9 0 3 0 12 0 
15 0 0 0 0 7 0 0 4 0 13 3 5 1 6 16 
13 12 0 1 0 2 0 15 10 8 0 0 4 0 7 14 
3 7 0 4 11 1 0 16 0 14 0 0 0 2 0 0 
0 0 0 0 15 3 0 0 6 0 0 0 8 0 14 0 
0 0 15 14 8 0 0 6 2 0 10 0 7 11 0 0 
6 9 3 7 4 0 0 14 0 13 0 0 0 0 10 0 
0 0 0 5 2 12 11 0 0 16 0 0 6 3 15 0 
0 0 5 0 9 4 0 0 12 1 15 0 0 16 0 3 
4 1 0 16 0 13 0 2 3 0 0 0 15 8 9 0 
0 15 7 0 16 0 0 1 9 4 2 8 14 0 0 0 
14 2 0 9 10 0 0 11 0 7 0 16 0 0 1 0 
