16
5 0 14 2 9 0 0 0 7 3 0 8 12 11 15 4 
0 12 0 0 13 15 2 11 14 0 0 0 8 7 0 0 
9 0 0 11 0 12 6 0 0 0 0 15 0 10 1 13 
0 4 0 15 0 0 7 8 6 0 11 0 3 16 0 0 
0 2 0 0 11 0 0 14 0 0 0 0 0 0 9 0 
0 11 0 0 0 16 9 2 0 0 14 7 0 5 0 10 
0 13 5 6 0 7 0 3 0 0 0 12 16 0 0 0 
15 16 9 3 0 0 12 0 0 8 0 11 7 2 13 0 
7 15 0 4 0 0 0 0 11 13 0 0 0 0 0 2 
0 0 0 5 0 0 0 0 8 7 16 2 1 0 0 0 
0 0 0 0 2 0 16 0 0 10 6 5 11 3 4 0 
2 10 0 9 7 11 1 12 4 0 15 0 0 0 0 8 
0 0 2 13 10 9 14 0 0 16 0 6 5 4 12 0 
0 0 10 7 16 3 5 13 12 0 0 0 15 1 8 6 
0 1 0 0 0 2 0 6 3 0 8 13 10 0 0 0 
0 5 0 16 0 8 0 0 0 0 0 0 2 0 0 0 
