16
16 8 0 0 3 9 6 1 14 0 0 0 13 0 10 11 
15 9 2 0 10 11 0 0 0 16 8 13 0 0 0 5 
11 0 1 0 5 16 0 13 4 2 7 0 8 0 0 15 
0 3 0 13 0 12 2 15 0 6 1 11 0 0 0 9 
0 15 0 0 16 0 5 0 0 13 0 1 0 8 0 7 
13 0 0 0 7 0 0 11 12 0 3 0 10 9 15 0 
7 0 0 1 12 15 0 6 0 8 16 10 0 4 0 13 
10 0 0 0 0 0 0 0 7 0 0 0 0 0 6 1 
6 0 0 0 13 0 0 0 0 0 0 2 11 3 9 8 
0 0 12 0 0 8 1 0 0 7 0 0 0 0 0 6 
0 1 15 0 11 6 3 0 0 0 13 12 0 10 0 0 
8 0 13 5 0 0 7 10 0 0 0 0 0 0 0 12 
14 0 5 15 1 0 10 8 0 0 0 0 6 11 0 2 
2 7 0 0 0 14 16 5 6 0 15 0 0 13 0 0 
4 6 10 12 0 13 0 0 0 0 14 7 0 0 0 3 
1 13 11 0 6 7 0 0 0 0 0 8 9 0 4 0 
