16
0 14 0 3 9 0 0 0 0 0 11 0 0 0 8 0 
8 9 16 4 0 0 0 0 14 10 13 0 0 2 0 0 
0 0 0 0 15 0 0 0 2 0 0 0 0 0 0 4 
6 0 0 0 0 0 0 0 0 9 4 0 0 0 0 0 
7 3 5 0 14 0 15 9 13 0 0 0 0 16 1 0 
1 0 15 9 4 0 0 8 0 0 16 0 14 0 10 12 
0 12 14 0 0 0 6 0 8 1 0 9 0 0 5 0 
10 6 0 0 13 5 16 0 15 0 0 12 0 0 0 7 
15 16 0 0 6 4 0 0 0 5 8 14 0 7 0 9 
5 4 1 0 8 0 0 7 3 11 2 16 12 10 15 0 
0 0 0 0 0 16 1 0 4 15 0 0 0 0 3 8 
0 0 9 7 3 15 14 0 1 13 0 0 5 4 16 2 
9 0 6 5 10 14 2 0 7 0 1 13 8 0 12 0 
16 0 12 15 0 0 0 13 0 8 0 4 9 0 2 0 
14 0 0 13 16 11 12 5 9 0 15 3 7 1 4 0 
0 7 0 10 0 0 0 15 11 14 0 0 0 0 0 0 
