16
0 12 13 9 0 0 5 7 0 11 2 10 0 3 0 6 
5 0 0 0 13 12 0 11 0 16 1 15 2 0 0 0 
0 0 11 1 0 9 0 0 5 0 0 0 13 0 0 0 
16 0 8 0 14 1 3 0 0 9 12 13 0 0 5 10 
15 0 4 13 7 14 0 0 0 8 0 0 16 6 0 0 
0 0 3 0 0 0 12 4 0 0 5 14 0 9 0 0 
0 5 0 12 9 6 15 0 0 0 4 0 0 0 8 7 
0 0 9 0 16 0 11 3 2 0 0 6 0 0 0 4 
3 4 0 0 0 5 14 0 0 12 0 7 9 0 13 0 
8 0 0 0 6 7 4 13 0 1 11 2 5 0 0 14 
10 7 0 16 0 11 2 12 0 0 0 0 0 8 3 0 
0 0 1 14 3 0 16 9 0 4 0 0 0 0 0 0 
12 0 0 0 11 0 0 0 9 2 0 1 0 15 0 13 
0 0 15 0 12 4 0 0 13 0 0 11 0 2 7 9 
9 0 0 7 0 15 0 0 0 6 0 4 14 0 16 0 
11 13 0 0 0 3 9 0 7 10 15 0 0 12 6 5 
