16
0 9 12 0 0 5 0 0 0 13 0 0 16 2 14 0 
0 0 16 0 0 0 7 6 2 0 9 0 1 0 0 5 
0 0 0 3 0 0 0 0 0 0 0 0 0 0 10 0 
7 0 2 13 0 16 12 11 0 5 0 10 0 0 4 0 
0 8 4 12 0 6 0 0 11 0 7 0 13 0 2 0 
0 13 0 9 11 12 10 2 0 6 0 0 0 14 8 0 
15 0 0 0 7 0 0 3 0 0 13 0 6 0 11 1 
2 3 0 0 1 0 16 0 12 14 0 15 4 7 5 10 
0 0 0 0 0 0 9 10 0 0 0 13 7 16 1 11 
12 0 0 16 0 4 0 8 9 0 2 5 10 13 3 14 
14 0 0 0 5 11 0 0 0 0 0 6 8 0 12 0 
0 0 0 8 15 0 0 0 1 7 0 0 9 0 6 2 
9 5 0 10 0 0 3 0 0 8 12 11 2 0 16 0 
6 0 0 0 8 0 11 0 0 1 0 0 5 0 0 3 
0 11 0 7 16 0 15 0 13 4 6 2 14 0 9 0 
16 0 13 4 2 0 0 0 0 9 5 14 0 1 7 8 
