16
0 15 10 0 0 4 0 13 0 0 9 11 6 0 1 0 
0 0 0 9 1 10 16 0 0 15 0 6 0 5 4 0 
0 0 2 0 9 0 11 5 4 10 7 0 15 3 0 0 
11 0 0 6 0 0 0 0 0 1 0 0 7 0 16 0 
0 3 0 0 0 0 0 2 0 0 0 13 0 1 0 12 
0 0 0 4 0 0 0 1 0 7 3 15 0 11 0 2 
0 0 0 8 6 3 13 0 16 0 11 1 0 4 15 5 
0 0 15 0 0 0 12 4 0 8 0 2 13 10 7 3 
12 6 0 10 0 13 0 0 15 0 0 3 1 16 0 11 
0 2 0 0 0 0 6 0 0 0 8 10 0 0 0 0 
0 0 16 0 2 0 5 10 0 9 0 12 0 0 8 4 
0 0 0 0 0 0 0 9 11 5 14 16 10 0 2 0 
4 8 12 0 0 5 0 6 13 14 0 0 0 15 11 0 
0 5 11 16 0 7 0 0 0 3 12 0 0 6 10 0 
13 7 0 14 0 0 4 15 0 11 1 9 12 8 0 16 
10 0 0 3 0 12 0 11 5 6 0 0 2 14 13 0 
