16
15 0 0 8 0 7 0 0 0 0 0 0 13 0 3 0 
1 0 13 0 0 0 0 2 0 0 6 0 4 0 0 0 
0 4 9 0 0 0 0 12 16 2 0 0 0 0 7 14 
2 0 14 7 6 0 4 0 13 8 15 0 1 9 12 11 
12 0 4 0 0 0 0 10 1 0 5 0 0 0 0 9 
0 13 0 0 0 0 0 0 0 11 3 0 0 0 0 6 
0 10 16 1 8 0 11 5 14 6 0 0 7 0 2 12 
0 8 0 2 13 15 0 0 0 9 16 0 14 10 0 1 
0 0 0 0 0 3 0 0 8 0 0 0 0 14 10 13 
8 0 0 0 14 0 9 13 12 0 0 5 3 0 4 16 
0 9 3 16 0 0 0 0 0 14 0 0 12 5 1 0 
0 7 11 14 16 12 5 0 3 0 0 0 0 0 9 0 
0 6 10 0 4 0 0 16 5 3 0 9 11 0 0 15 
0 0 8 5 0 0 7 15 11 4 12 13 0 0 0 2 
11 1 15 9 0 8 13 0 2 7 10 16 0 0 6 4 
0 0 12 4 0 0 1 0 6 15 8 0 0 16 0 3 
