16
0 8 15 0 2 5 0 6 0 0 0 0 0 11 1 12 
9 6 5 0 7 0 14 13 15 1 11 0 0 0 0 0 
10 0 16 2 0 0 3 1 0 0 5 0 0 14 0 9 
12 1 4 0 10 11 16 9 0 8 0 14 0 5 0 15 
7 0 1 0 0 0 8 0 2 6 10 0 0 9 0 0 
6 0 0 11 1 7 0 0 0 0 9 16 0 8 10 2 
3 0 8 0 0 13 0 0 0 0 14 1 15 6 12 0 
14 0 2 10 0 6 0 0 5 13 0 8 0 7 11 3 
0 0 0 16 0 0 0 3 0 15 0 0 0 4 0 0 
11 12 0 0 0 0 9 0 0 10 1 0 5 3 8 0 
0 4 0 0 5 0 12 2 7 0 0 3 0 0 15 0 
15 2 0 0 14 0 0 8 0 5 16 13 0 12 6 11 
0 0 0 15 0 0 10 0 0 0 0 6 11 0 0 0 
0 0 11 0 0 9 13 12 0 14 15 0 2 0 7 0 
0 0 6 12 0 0 0 0 10 3 0 9 14 0 0 0 
0 10 0 5 0 14 0 7 8 0 0 11 12 0 3 4 
