16
0 12 0 0 10 0 11 0 6 0 16 15 5 7 3 0 
8 5 3 0 15 6 0 2 0 10 11 0 13 4 0 16 
0 0 0 0 13 1 7 16 0 3 5 0 0 0 0 0 
7 16 0 0 9 0 0 14 2 0 0 0 0 11 0 0 
0 11 15 0 0 10 5 0 1 0 12 7 0 2 0 6 
0 14 0 13 16 0 6 0 15 0 0 0 7 12 0 10 
0 0 1 0 2 7 0 0 14 5 6 4 15 0 0 0 
0 7 12 0 0 15 0 13 16 0 10 2 1 3 8 9 
1 10 0 16 6 12 2 0 0 0 7 14 0 8 0 13 
9 2 0 0 0 0 0 0 5 0 0 10 0 0 0 12 
6 0 0 7 0 3 0 0 0 15 0 0 0 16 0 0 
4 0 0 12 0 9 0 7 11 0 0 16 6 0 1 0 
14 0 7 0 0 0 0 8 0 0 15 1 16 0 0 3 
0 0 0 5 0 0 15 11 0 16 2 0 0 0 12 0 
0 13 0 10 1 4 9 3 8 7 0 0 0 6 0 0 
15 0 0 0 5 0 16 0 3 12 13 0 0 0 10 7 
