16
0 14 12 0 0 0 0 0 0 0 10 0 4 13 3 0 
6 4 0 0 14 10 2 0 0 8 15 13 0 0 0 0 
3 15 0 0 13 0 0 0 0 9 0 12 0 0 0 0 
0 5 0 8 0 12 3 4 1 0 11 0 0 0 0 0 
15 12 2 14 0 5 1 0 0 0 0 11 0 0 16 0 
8 10 0 11 6 0 0 0 0 3 7 0 12 1 0 0 
0 9 7 0 0 4 0 15 0 1 2 14 10 0 5 3 
1 3 0 0 8 0 10 0 13 6 0 0 0 7 0 0 
0 0 9 5 0 14 12 0 2 0 1 3 6 0 0 0 
14 0 0 15 0 3 0 0 8 0 0 0 1 9 13 12 
2 16 8 0 0 0 15 1 0 0 0 10 0 5 0 0 
12 13 0 1 0 11 7 0 15 0 9 5 0 0 0 10 
0 6 15 13 0 0 0 3 4 2 0 0 0 0 10 11 
11 0 14 0 12 0 13 5 0 0 0 9 0 4 2 1 
0 0 3 16 7 8 4 0 11 0 0 1 15 0 0 5 
10 0 0 0 2 0 11 0 0 7 0 16 8 3 9 13 
