16
0 12 0 16 10 11 7 14 3 0 0 5 0 0 0 0 
0 0 6 0 9 0 16 0 10 0 0 0 0 3 15 0 
0 13 10 0 0 3 0 8 16 4 2 0 7 0 0 0 
0 1 0 3 0 15 0 0 0 14 11 0 0 0 0 10 
0 15 5 0 4 8 0 0 0 9 0 3 16 0 0 0 
12 14 4 2 0 0 15 5 0 0 0 0 1 7 0 8 
0 10 0 0 16 6 0 12 0 0 4 0 14 0 13 5 
16 0 9 7 0 0 11 0 0 15 5 0 3 2 0 6 
4 7 0 12 0 10 5 3 0 0 9 15 0 6 0 0 
0 0 0 0 7 12 0 0 0 0 0 0 0 1 0 0 
14 2 15 0 11 16 0 9 5 1 0 0 0 0 0 3 
0 0 11 0 0 0 0 0 2 12 7 0 0 0 16 9 
0 0 8 6 0 0 3 4 0 10 14 0 12 11 2 16 
13 9 12 1 14 0 8 0 0 0 0 0 0 0 0 7 
2 0 16 0 13 9 10 11 0 6 0 7 5 14 8 0 
10 0 14 0 5 7 12 16 1 0 0 8 0 13 0 15 
