16
0 0 11 14 0 12 0 0 0 0 15 0 9 5 0 1 
5 0 0 0 0 4 11 13 0 0 10 0 0 0 14 0 
10 16 8 7 0 0 1 15 0 0 14 9 0 11 0 0 
13 15 0 2 9 3 0 10 16 11 0 5 4 8 0 0 
9 0 0 3 0 16 5 14 0 0 0 2 0 0 0 0 
0 0 16 0 0 2 0 0 0 0 9 10 0 1 6 0 
0 0 4 0 0 0 0 0 5 0 0 11 0 10 0 3 
0 5 10 15 4 11 0 0 12 7 6 0 0 13 0 2 
14 10 13 4 0 0 2 0 15 3 0 12 0 6 1 9 
0 0 0 0 14 0 15 6 4 1 13 0 0 12 0 0 
0 8 0 0 12 1 0 0 0 0 0 0 16 3 0 13 
1 0 0 11 0 0 0 0 10 9 0 6 0 0 5 0 
12 0 0 5 1 10 16 9 2 0 3 0 0 15 4 0 
0 6 0 0 0 0 4 5 14 10 0 16 12 0 3 8 
0 0 0 10 0 14 0 8 9 6 0 0 1 2 0 16 
16 0 9 8 3 15 0 0 1 0 7 4 0 0 0 5 
