16
16 0 10 11 7 0 2 3 0 9 0 0 4 0 0 0 
14 3 0 0 8 0 10 0 0 16 0 1 0 2 11 0 
4 0 12 2 0 6 5 13 14 0 11 0 0 0 0 0 
0 0 13 0 0 0 16 0 4 3 2 0 12 0 9 0 
0 4 0 15 11 0 8 0 0 0 0 0 0 6 0 0 
9 10 0 1 0 2 0 4 16 5 14 11 0 0 3 8 
0 6 0 0 16 0 13 5 7 0 9 0 0 4 0 0 
0 5 14 0 12 0 0 0 0 0 0 8 11 0 16 9 
0 2 8 4 0 16 0 0 11 0 5 14 15 0 7 0 
0 0 15 3 0 0 0 8 2 0 16 0 0 5 0 1 
10 0 11 6 2 0 14 15 13 7 1 0 16 0 0 0 
0 16 5 14 0 12 4 0 10 6 0 0 9 11 2 0 
2 0 4 5 0 0 0 9 0 0 0 0 0 0 0 16 
6 11 3 16 0 0 0 7 0 0 15 4 0 13 0 2 
15 14 0 0 0 10 0 2 5 0 7 0 8 9 0 11 
0 7 0 0 0 13 11 16 0 0 0 0 5 0 12 0 
