16
11 0 8 0 2 7 5 14 0 0 10 3 0 4 13 16 
1 2 0 0 0 0 0 0 14 7 4 13 3 8 6 9 
14 0 0 9 1 0 0 0 2 0 15 6 5 11 0 10 
4 10 7 13 0 0 0 3 0 11 0 8 14 0 1 12 
2 0 0 0 0 14 0 0 1 6 9 5 7 0 8 0 
0 0 0 0 0 2 3 0 13 0 11 0 1 0 0 0 
0 0 4 0 7 0 6 0 3 8 2 0 10 0 0 0 
0 0 10 0 0 0 1 8 0 0 7 0 2 0 0 6 
0 7 0 0 0 15 0 2 6 0 0 10 9 0 0 0 
0 5 2 10 14 1 0 0 0 9 3 0 0 13 15 0 
0 0 0 16 0 3 7 5 15 0 0 0 12 0 0 2 
15 0 0 1 0 13 0 9 8 5 0 0 0 3 0 0 
0 11 0 0 0 0 0 0 0 3 0 0 0 9 12 0 
0 15 13 0 0 16 0 6 0 0 12 1 8 7 0 0 
12 0 5 0 0 8 0 0 10 15 16 0 6 0 2 11 
0 9 0 0 15 12 0 11 5 13 0 0 4 10 16 3 
