16
0 0 0 0 0 9 0 0 2 0 0 4 11 10 16 5 
0 0 0 5 10 0 0 0 9 0 0 0 12 0 2 7 
6 0 0 0 0 0 0 4 0 7 0 10 0 9 0 15 
2 0 10 0 0 8 0 0 0 13 12 0 0 0 6 0 
0 6 9 0 0 0 0 14 0 12 10 15 2 7 8 0 
0 2 16 0 9 3 13 6 5 0 11 7 0 12 0 0 
0 0 0 10 0 0 0 8 6 3 13 0 0 0 0 0 
14 0 5 0 0 10 4 0 16 9 0 0 6 1 0 13 
10 11 8 1 16 6 12 9 15 0 14 0 3 0 0 2 
9 4 3 0 0 0 0 0 11 0 7 0 15 16 0 6 
16 0 0 0 2 4 0 11 3 0 0 1 5 8 9 0 
0 0 0 0 0 0 0 10 0 4 0 9 0 0 1 14 
11 16 12 0 0 0 5 0 7 0 4 6 10 0 3 8 
0 13 0 2 8 0 3 0 0 11 0 16 0 6 14 0 
0 0 14 0 0 13 9 0 0 15 0 12 0 0 0 0 
5 7 0 8 0 11 10 2 13 0 9 0 1 15 12 0 
