16
0 0 0 9 0 3 0 4 7 12 6 15 0 0 0 0 
12 2 16 14 1 6 0 0 0 0 11 10 0 9 13 8 
0 5 0 0 0 0 0 9 0 13 0 0 12 0 15 0 
0 7 0 3 14 0 0 0 5 8 0 9 0 0 0 0 
0 0 0 8 0 0 0 0 0 16 0 0 9 0 14 5 
0 6 10 4 0 1 0 8 0 0 5 0 0 0 3 15 
0 1 14 5 15 0 3 13 0 10 8 0 0 0 0 6 
0 12 7 0 0 0 2 16 9 0 0 0 4 8 1 10 
13 0 12 11 0 0 0 0 16 9 14 2 0 15 0 0 
14 0 5 0 0 15 0 0 6 0 0 0 0 10 2 0 
7 0 1 2 16 13 9 10 0 0 0 0 0 6 11 0 
6 0 9 0 0 4 14 2 0 7 10 1 3 5 0 13 
8 0 0 0 3 2 0 15 10 5 13 11 0 0 0 0 
0 0 0 7 0 8 4 1 0 0 0 16 6 0 0 2 
3 0 0 0 13 11 7 0 0 0 9 0 0 12 0 1 
0 14 0 12 9 16 0 0 2 1 7 0 0 13 8 11 
