16
0 16 13 1 0 15 5 0 12 14 0 0 2 0 0 0 
10 8 12 14 6 0 1 16 0 4 0 7 9 11 0 0 
6 0 0 5 14 0 0 0 0 8 1 0 0 0 0 0 
7 15 4 0 0 11 0 0 0 9 0 0 0 0 0 16 
16 0 0 15 11 14 2 10 13 5 7 0 0 6 9 4 
5 13 1 6 15 16 4 0 0 0 0 9 14 8 7 0 
11 9 0 10 13 0 8 0 0 0 0 14 0 2 0 12 
0 0 2 8 0 0 0 0 6 0 0 0 13 10 16 0 
1 0 0 0 10 0 0 11 4 2 0 0 0 0 13 8 
0 0 0 13 0 3 9 14 11 7 5 0 16 15 4 2 
0 7 0 12 5 0 0 0 0 1 0 13 0 0 10 6 
0 11 0 0 0 0 15 2 0 6 16 10 0 0 0 0 
12 0 9 0 0 0 14 15 5 0 6 4 0 0 1 7 
0 10 6 7 12 0 0 0 1 0 0 0 0 0 11 0 
0 4 0 0 16 0 0 0 0 10 0 0 15 0 6 3 
0 1 0 0 4 0 11 6 0 12 3 0 0 0 0 9 
