16
0 0 0 0 0 11 4 6 10 0 0 9 0 2 0 0 
13 10 0 0 3 2 0 0 0 0 8 16 7 15 11 5 
0 11 0 14 0 0 15 16 2 0 12 6 0 0 8 4 
0 0 2 0 0 0 10 0 7 0 5 0 9 0 6 0 
0 0 0 0 4 10 16 0 1 7 6 0 11 9 0 13 
1 13 4 0 9 6 0 8 5 10 3 2 15 14 12 0 
3 6 10 0 13 12 11 0 0 16 0 14 0 0 0 2 
0 14 9 0 0 15 3 0 0 8 0 0 0 0 0 0 
0 15 0 0 2 13 0 0 0 4 10 8 0 11 0 0 
0 5 0 9 0 7 0 0 15 2 0 11 6 16 0 0 
0 0 0 4 16 0 0 0 3 0 7 13 2 0 5 1 
2 0 16 0 11 9 14 0 0 0 1 5 8 0 0 0 
0 7 14 0 0 16 0 0 12 0 0 4 5 0 1 0 
0 0 1 2 6 0 13 0 8 0 0 0 0 12 15 11 
5 0 15 0 0 1 12 0 13 6 0 0 0 0 0 8 
0 8 6 0 0 0 0 0 14 0 16 0 0 3 9 0 
