16
14 13 0 12 0 0 15 16 2 11 8 0 0 1 0 9 
1 0 15 10 0 0 0 0 16 0 14 0 2 0 0 7 
0 0 0 8 0 0 1 13 7 0 4 0 15 0 16 0 
0 11 0 0 2 10 0 9 1 0 0 0 0 13 0 0 
3 0 0 0 0 0 0 0 13 0 0 6 0 0 14 10 
0 14 12 4 9 15 16 0 0 7 10 0 13 0 0 0 
13 0 0 0 0 0 5 0 3 0 0 16 0 0 9 1 
6 15 0 5 0 0 10 0 0 0 0 9 3 11 7 0 
15 0 0 0 0 0 0 0 12 3 7 8 16 0 0 5 
0 0 10 3 15 0 13 0 0 0 0 0 0 0 0 0 
5 0 9 0 16 7 12 0 0 13 0 0 1 4 0 0 
4 12 8 11 0 0 2 0 0 0 16 5 0 0 10 13 
0 0 16 0 13 11 0 15 5 2 6 7 9 3 12 0 
12 0 13 15 0 0 9 0 0 16 3 0 0 0 1 6 
2 4 3 0 0 12 6 7 8 10 1 11 14 0 13 0 
11 5 0 6 0 16 3 0 9 0 13 0 10 0 0 8 
