16
0 10 2 0 16 15 4 6 7 0 12 0 0 14 0 0 
1 0 0 9 8 0 0 0 15 3 0 16 11 7 6 5 
0 3 6 0 9 13 5 11 2 0 0 1 0 12 0 0 
5 11 0 14 1 3 0 0 6 4 0 0 13 15 0 0 
0 14 15 0 6 0 13 1 5 10 0 0 3 11 16 12 
6 13 0 0 5 7 0 4 0 2 0 0 0 0 0 0 
0 5 0 2 3 16 0 0 12 0 0 15 4 9 14 13 
8 0 0 0 0 10 0 0 0 13 0 4 0 0 5 0 
2 0 0 0 15 1 0 0 0 0 0 0 0 8 0 16 
0 4 9 6 0 0 0 0 0 15 0 10 2 3 0 0 
0 0 0 11 10 0 12 0 16 0 0 0 6 13 9 7 
0 16 0 12 11 0 2 0 0 1 6 7 0 0 0 0 
11 0 14 0 2 0 3 16 10 0 0 0 0 0 0 6 
0 0 3 7 0 0 0 5 14 0 0 0 0 0 0 4 
12 0 8 0 4 0 15 10 1 7 0 5 0 0 0 11 
4 2 10 0 14 11 0 0 0 16 15 0 12 0 13 0 
