16
2 5 0 0 11 0 8 0 0 7 10 13 1 12 0 14 
12 1 10 6 14 15 0 0 0 4 0 8 0 0 13 11 
7 0 0 4 0 0 0 0 0 5 15 0 0 0 0 8 
8 0 15 14 7 0 0 13 2 0 0 9 0 0 0 6 
14 15 16 0 0 0 0 1 10 0 0 5 0 0 0 0 
10 6 0 0 0 0 0 0 9 0 8 0 13 0 0 12 
0 7 8 12 5 0 0 14 4 15 2 0 0 9 0 0 
11 9 0 0 8 7 0 15 0 1 13 3 14 0 6 0 
6 13 12 0 10 0 16 0 8 0 5 2 7 0 0 4 
1 2 11 10 13 0 15 6 0 0 0 4 0 0 0 16 
0 0 0 0 0 0 7 11 0 0 0 15 0 0 0 13 
0 3 0 0 1 14 0 5 13 0 0 0 0 11 0 2 
0 0 0 7 0 11 0 10 0 13 0 6 0 4 0 9 
0 14 1 11 0 0 6 7 15 8 0 10 0 13 0 3 
0 8 0 0 0 1 9 0 0 0 0 12 5 0 0 10 
0 10 0 0 12 0 13 0 1 2 0 14 11 6 0 15 
