16
16 4 0 0 0 7 2 0 10 5 8 0 0 14 0 0 
10 0 0 0 0 16 0 3 4 13 14 9 15 7 11 5 
0 1 7 0 15 0 0 0 3 2 12 0 0 0 0 0 
0 0 8 11 0 0 4 0 16 15 1 0 12 10 6 0 
2 14 5 0 6 0 15 0 1 0 7 4 0 13 0 12 
0 12 0 4 0 0 5 0 13 0 0 0 7 15 0 16 
15 8 10 3 0 13 11 7 9 0 6 0 0 0 14 1 
0 0 16 0 9 0 12 4 0 0 0 10 2 0 0 0 
0 10 6 2 0 0 0 15 0 1 3 0 0 12 5 11 
8 0 0 0 13 0 0 10 0 0 0 14 16 0 0 7 
0 0 14 16 0 11 0 0 0 10 13 12 4 0 15 8 
0 0 0 0 0 9 0 0 15 0 0 0 0 6 13 0 
0 0 0 12 10 0 0 6 0 0 5 0 1 9 7 15 
0 13 0 8 4 5 0 12 0 0 0 0 0 0 0 0 
0 6 0 7 11 15 16 0 12 0 2 0 0 5 8 0 
0 5 2 0 3 8 7 14 0 9 0 0 0 0 0 4 
