16
0 8 6 14 0 10 9 0 0 0 0 4 0 5 0 0 
0 0 7 5 3 13 6 0 0 14 0 0 0 0 8 15 
0 0 2 15 0 12 0 4 0 8 0 0 7 13 0 0 
0 0 13 10 0 0 0 0 0 2 0 12 0 0 9 11 
0 0 1 0 15 7 0 0 0 0 12 8 14 0 4 10 
0 7 0 8 1 4 12 0 0 0 16 3 6 9 15 0 
0 2 12 11 0 0 8 16 0 0 0 14 0 0 5 0 
5 0 4 16 0 9 2 0 1 7 15 0 11 3 0 8 
2 0 10 1 0 0 16 9 12 3 0 0 5 14 0 4 
0 0 11 12 5 15 10 8 0 0 14 0 9 0 0 3 
0 0 0 3 12 0 0 0 0 15 5 0 0 8 0 13 
8 0 5 0 4 6 0 0 13 0 9 2 0 0 11 0 
0 11 3 0 0 0 13 0 4 0 0 6 0 0 0 1 
14 0 0 0 0 0 0 6 0 11 7 0 3 0 13 0 
13 5 0 0 0 0 0 0 0 1 10 15 0 0 2 0 
0 10 15 2 9 0 11 12 3 0 13 5 0 7 0 6 
