16
15 1 0 2 0 3 0 12 0 16 6 10 0 7 4 13 
0 0 0 0 7 0 4 5 0 0 13 0 0 15 0 0 
13 0 0 7 0 2 0 0 0 0 4 0 0 0 0 10 
9 5 16 4 0 0 0 0 7 0 8 0 0 12 11 0 
2 11 1 0 14 0 0 6 0 5 0 16 0 13 0 0 
12 0 6 0 0 4 0 0 9 0 11 0 0 1 3 7 
16 10 13 0 0 12 0 11 0 0 2 7 4 8 0 0 
14 0 4 9 5 0 0 0 12 0 0 13 11 16 0 6 
5 0 0 0 4 6 7 2 0 0 0 8 0 0 12 0 
3 0 10 0 15 0 0 0 13 4 0 0 0 6 7 16 
0 0 12 16 11 10 13 0 0 2 7 0 0 0 0 0 
0 0 7 0 12 0 5 3 0 14 0 0 0 4 0 0 
4 6 2 13 8 0 12 0 11 10 0 0 0 0 0 9 
0 0 15 0 0 0 3 0 2 0 0 0 1 10 0 11 
1 3 14 0 10 0 2 9 16 7 0 6 8 5 13 4 
0 0 0 10 0 0 6 7 8 0 0 4 0 0 15 12 
