16
14 7 2 0 11 16 9 3 13 1 10 0 5 0 0 0 
0 3 0 6 0 0 0 1 0 0 7 12 0 11 13 0 
1 0 0 8 0 12 13 10 9 0 0 11 0 0 0 15 
0 12 10 11 0 0 6 0 3 14 15 4 7 16 1 0 
8 0 0 0 14 7 3 0 0 0 16 0 0 10 0 0 
0 0 0 3 9 10 0 0 4 0 0 0 0 0 0 0 
16 0 12 0 2 15 0 0 0 0 11 0 0 0 0 0 
10 0 5 0 0 0 16 0 0 7 0 2 14 3 15 4 
0 4 0 10 0 9 5 0 12 0 0 1 3 0 2 14 
11 5 0 1 0 0 0 15 16 2 3 0 4 0 0 12 
15 14 0 0 4 3 0 8 7 0 0 0 0 13 11 0 
0 0 0 12 1 6 2 11 0 4 0 10 0 0 0 0 
0 1 15 0 3 2 0 0 10 0 0 5 0 6 0 0 
0 10 0 16 6 0 0 0 0 0 0 15 12 7 5 0 
0 8 3 0 0 0 0 0 11 6 0 7 0 0 10 1 
9 11 6 0 12 1 0 7 14 3 0 0 15 4 0 13 
