16
0 10 0 1 12 13 0 14 16 0 8 0 0 0 4 0 
0 2 5 0 0 0 16 9 0 0 0 4 0 0 0 8 
16 7 0 13 6 5 0 8 0 9 0 0 12 15 2 0 
8 12 0 4 7 15 0 0 0 0 5 13 0 0 6 16 
0 0 10 11 13 8 5 3 0 0 4 7 0 14 0 0 
5 0 0 8 0 0 12 0 0 0 0 0 7 16 0 11 
0 16 0 2 0 9 0 0 11 3 6 12 10 0 0 5 
0 0 0 0 16 10 0 0 0 0 0 2 3 6 0 0 
0 0 1 0 5 0 0 16 2 10 11 8 0 7 3 12 
2 11 0 0 0 7 0 10 0 4 16 5 6 0 0 0 
0 0 0 0 8 4 0 0 0 0 0 0 0 2 0 15 
7 0 0 0 1 11 0 13 12 6 0 14 8 10 5 0 
0 0 13 5 0 16 8 0 4 14 0 0 0 1 11 0 
0 14 0 6 0 0 13 0 0 1 2 11 0 5 0 0 
0 8 2 0 11 12 1 0 5 0 0 0 0 4 9 3 
0 0 4 0 0 2 14 5 0 8 0 0 0 12 7 13 
