16
2 0 0 0 0 16 0 9 4 0 0 0 0 3 6 11 
10 11 3 8 0 4 0 7 0 15 0 12 0 0 0 1 
9 4 15 12 5 3 0 0 13 0 16 0 7 2 0 0 
13 0 0 0 0 0 11 2 0 5 14 0 0 4 10 12 
0 0 13 0 0 0 3 0 10 0 0 4 0 0 11 16 
3 14 10 0 7 0 0 4 0 11 0 0 6 9 2 0 
0 12 0 0 16 2 0 0 7 0 0 3 10 0 15 0 
0 0 0 0 0 14 0 0 0 0 0 0 0 13 4 7 
15 13 0 3 14 0 7 0 5 12 0 0 0 6 0 0 
7 0 0 6 0 0 15 0 16 0 9 0 11 8 14 3 
12 16 0 0 4 6 0 3 0 8 11 10 5 0 0 0 
0 9 5 4 0 11 16 13 14 3 0 6 2 12 1 0 
4 0 12 0 0 10 8 0 11 7 0 14 16 0 9 0 
0 0 7 11 0 0 0 16 9 13 0 0 8 0 0 0 
0 0 0 13 0 0 0 12 0 0 0 1 0 15 0 2 
0 0 8 0 3 13 0 14 12 0 6 0 0 11 7 0 
