16
0 0 0 13 1 0 7 15 10 0 2 12 0 6 8 11 
0 10 0 0 0 11 8 2 16 4 0 0 0 0 0 0 
0 8 0 5 0 4 13 3 11 0 7 1 10 0 0 16 
14 0 0 11 16 12 0 10 0 6 0 15 0 0 5 4 
0 3 12 9 0 16 1 0 0 0 0 10 6 0 0 0 
1 0 6 10 7 3 14 0 0 13 0 4 8 0 15 0 
0 0 0 0 2 5 0 0 0 0 12 6 16 9 1 3 
0 0 14 0 15 9 6 12 0 7 0 3 11 0 0 10 
4 0 7 12 14 2 0 16 0 1 0 0 0 0 0 6 
0 0 0 0 0 10 15 1 4 0 13 0 5 0 0 8 
0 11 8 0 3 0 0 6 7 0 0 16 0 0 9 2 
0 5 0 2 8 7 12 4 0 0 0 0 0 14 16 0 
8 0 9 0 11 15 16 0 0 10 0 0 4 12 2 13 
0 0 0 0 12 6 0 0 0 15 0 5 0 16 0 0 
0 0 5 7 0 8 0 0 12 16 0 11 0 0 3 1 
0 0 0 0 0 0 0 7 13 0 0 0 0 0 0 5 
