16
0 0 0 0 2 5 9 0 0 0 0 14 0 1 0 0 
2 0 0 0 14 6 15 4 10 3 0 0 0 13 0 9 
9 12 0 0 10 0 3 1 16 5 13 0 2 0 14 15 
0 0 0 0 13 16 0 7 2 1 0 0 0 5 0 0 
13 0 0 0 6 7 16 2 3 0 10 8 14 0 1 5 
0 6 11 16 5 0 0 13 15 0 14 0 0 12 0 0 
0 14 0 0 11 0 1 8 6 12 0 7 16 4 13 0 
10 0 7 0 0 0 0 12 13 0 0 0 3 0 0 0 
12 7 0 0 16 4 0 14 5 0 0 15 0 0 0 6 
5 0 0 0 0 1 0 10 0 9 12 6 7 0 0 0 
11 0 0 9 0 0 7 0 0 13 3 0 4 0 0 0 
6 0 14 13 0 11 5 0 4 10 7 16 12 15 3 0 
1 0 16 0 12 0 8 0 0 6 0 13 0 0 0 11 
0 9 0 2 0 0 0 0 0 15 16 10 0 0 0 4 
0 11 13 6 7 10 0 16 12 0 0 0 0 0 0 0 
7 0 4 0 0 13 6 0 11 14 2 0 1 0 0 0 
