9
5 3 4 0 7 8 9 0 2
0 0 2 1 0 0 3 4 0
1 9 8 0 4 2 5 6 7
8 5 0 0 6 1 0 2 3
4 2 0 8 5 3 0 9 1
7 0 3 9 0 4 8 5 6
9 6 1 5 0 7 0 8 0
2 0 7 0 1 9 6 3 5
3 4 0 2 8 0 1 0 9
