9
7 2 0 1 9 0 3 0 6 
0 4 3 0 0 0 0 9 0 
9 0 6 0 0 2 0 0 0 
0 0 0 0 2 0 5 0 7 
0 0 0 0 0 5 1 0 3 
0 0 0 8 0 1 2 4 0 
0 8 7 3 0 0 0 0 0 
0 3 0 0 1 0 0 7 0 
6 9 0 0 0 0 8 0 0 
