9
0 5 0 7 0 1 0 0 0 
4 0 0 0 0 0 5 0 2 
0 0 0 4 0 5 0 0 1 
9 2 3 8 0 7 4 0 6 
0 8 0 2 0 4 0 3 0 
1 0 5 6 9 3 0 0 7 
0 0 2 5 4 6 1 7 0 
0 3 0 0 7 2 0 0 0 
6 0 0 3 0 9 0 5 0 
