9
3 0 5 0 4 0 0 0 1 
4 1 6 0 5 0 7 8 3 
2 8 0 1 0 0 0 0 0 
0 3 0 4 2 0 1 6 0 
5 0 0 3 0 7 0 0 0 
0 4 0 0 0 6 0 7 0 
0 5 0 0 0 1 0 0 8 
0 2 0 0 0 0 6 1 0 
0 0 8 2 0 4 0 3 0 
