9
0 9 4 5 3 0 0 0 8 
0 0 8 0 7 0 0 0 0 
0 0 0 8 0 0 0 0 3 
3 0 0 7 6 0 0 0 0 
0 8 0 0 0 9 0 4 7 
0 0 7 0 2 0 0 0 0 
0 0 0 2 0 0 1 0 0 
4 0 3 6 0 7 0 9 0 
0 0 9 0 0 0 7 0 0 
