9
9 0 8 0 0 6 1 5 3 
0 0 0 0 7 1 2 8 9 
1 0 0 0 0 8 0 6 7 
2 0 0 0 3 4 6 1 5 
8 6 3 0 5 0 0 0 0 
0 5 0 9 0 0 0 7 0 
7 1 0 4 0 0 0 3 0 
0 0 4 6 0 3 0 0 0 
0 3 0 7 0 5 0 4 0 
